season,FTHG,FTAG,FTR,HomeStreak5,AwayStreak5,matchid,HomeStreak3,AwayStreak3,PointsHome,PointsAway,HomeResult5,AwayResult5,AwayScored,AwayConceded,HomeConceded,HomeScored,DifH,DifA,DifPoints,HV5,AV5,HV3,AV3
1112,2,2,D,0,0,1,0,0,0,0,0,0,0,0,0,0,0,0,0,0,0,0,0
1112,1,3,A,0,0,2,0,0,0,0,0,0,0,0,0,0,0,0,0,0,0,0,0
1112,0,0,D,0,0,3,0,0,0,0,0,0,0,0,0,0,0,0,0,0,0,0,0
1112,2,2,D,0,0,4,0,0,0,0,0,0,0,0,0,0,0,0,0,0,0,0,0
1112,2,0,H,0,0,5,0,0,0,0,0,0,0,0,0,0,0,0,0,0,0,0,0
1112,2,2,D,0,0,6,0,0,0,0,0,0,0,0,0,0,0,0,0,0,0,0,0
1112,4,1,H,0,0,7,0,0,0,0,0,0,0,0,0,0,0,0,0,0,0,0,0
1112,0,2,A,0,0,8,0,0,0,0,0,0,0,0,0,0,0,0,0,0,0,0,0
1112,4,3,H,0,0,9,0,0,0,0,0,0,0,0,0,0,0,0,0,0,0,0,0
1112,1,2,A,0,0,10,0,0,0,0,0,0,0,0,0,0,0,0,0,0,0,0,0
1112,2,1,H,1,0,11,1,0,3,1,0,1,2,2,1,2,1,0,2,0,0,0,0
1112,0,0,D,0,0,12,0,0,0,0,0,0,1,2,4,3,-1,-1,0,0,0,0,0
1112,1,0,H,0,1,13,0,1,1,3,1,3,4,3,2,2,0,1,-2,0,0,0,0
1112,0,2,A,0,0,14,0,0,0,0,0,0,0,2,2,0,-2,-2,0,0,0,0,0
1112,1,0,H,0,0,15,0,0,1,0,1,0,1,3,0,0,0,-2,1,0,0,0,0
1112,1,2,A,0,0,16,0,0,1,1,1,1,2,2,2,2,0,0,0,0,0,0,0
1112,3,1,H,1,0,17,1,0,3,1,0,1,2,2,1,3,2,0,2,0,0,0,0
1112,2,1,H,0,0,18,0,0,0,1,0,1,2,2,4,1,-3,0,-1,0,0,0,0
1112,0,1,A,0,1,19,0,1,1,3,1,3,4,1,0,0,0,3,-2,0,0,0,0
1112,2,0,H,1,1,20,1,1,3,3,0,3,2,0,0,2,2,2,0,0,0,0,0
1112,3,1,H,0,0,21,0,0,1,1,1,1,3,4,4,3,-1,-1,0,0,0,0,0
1112,1,2,A,0,0,22,0,0,0,1,0,1,3,4,4,1,-3,-1,-1,0,0,0,0
1112,1,0,H,0,2,23,0,2,1,6,1,6,6,2,4,3,-1,4,-5,0,0,0,0
1112,3,0,H,1,1,24,1,1,3,3,0,3,3,5,2,2,0,-2,0,0,0,0,0
1112,3,0,H,1,1,25,1,1,4,4,1,4,1,0,3,4,1,1,0,0,0,0,0
1112,1,1,D,2,0,26,2,0,6,0,0,0,0,4,1,5,4,-4,6,0,0,0,0
1112,1,2,A,1,1,27,1,1,3,4,0,4,3,2,2,2,0,1,-1,0,0,0,0
1112,1,1,D,0,2,28,0,2,1,6,1,6,4,0,5,3,-2,4,-5,0,0,0,0
1112,3,2,H,1,2,29,1,2,3,6,0,6,4,2,4,4,0,2,-3,0,0,0,0
1112,1,1,D,0,0,30,0,0,1,1,1,1,0,1,2,1,-1,-1,0,0,0,0,0
1112,1,3,A,0,0,31,0,0,1,1,1,1,4,7,5,1,-4,-3,0,0,0,0,0
1112,1,0,H,0,0,32,0,0,2,0,2,0,2,6,6,4,-2,-4,2,0,0,0,0
1112,0,0,D,2,2,33,2,2,6,6,0,6,5,2,3,6,3,3,0,0,0,0,0
1112,2,1,H,2,1,34,2,1,7,4,1,4,6,5,3,5,2,1,3,0,0,0,0
1112,0,0,D,2,2,35,2,2,6,7,0,7,5,1,5,6,1,4,-1,0,0,0,0
1112,1,1,D,1,2,36,1,2,4,7,1,7,6,2,3,1,-2,4,-3,0,0,0,0
1112,2,1,H,1,2,37,1,2,4,7,1,7,7,3,4,4,0,4,-3,0,0,0,0
1112,0,0,D,1,2,38,1,2,4,6,1,6,7,6,5,5,0,1,-2,0,0,0,0
1112,0,1,A,1,0,39,1,0,3,2,0,2,2,3,8,3,-5,-1,1,0,0,0,0
1112,3,0,H,0,1,40,0,1,2,3,2,3,3,4,2,1,-1,-1,-1,0,0,0,0
1112,0,3,A,1,2,41,0,2,4,7,1,7,6,3,8,7,-1,3,-3,0,0,0,0
1112,3,1,H,1,3,42,0,2,5,10,2,10,7,4,3,3,0,3,-5,0,0,0,0
1112,0,0,D,0,2,43,0,1,0,7,0,7,6,5,7,2,-5,1,-7,0,0,0,0
1112,1,2,A,2,1,44,2,1,7,5,1,5,5,5,2,5,3,0,2,0,0,0,0
1112,2,0,H,2,1,45,2,0,8,5,2,5,5,6,3,7,4,-1,3,0,0,0,0
1112,0,2,A,1,2,46,1,2,3,7,0,7,6,5,7,3,-4,1,-4,0,0,0,0
1112,3,3,D,1,1,47,1,1,4,5,1,5,2,4,7,7,0,-2,-1,0,0,0,0
1112,2,0,H,2,1,48,2,0,7,5,1,5,4,2,6,7,1,2,2,0,0,0,0
1112,3,1,H,1,2,49,1,2,3,7,0,7,8,5,9,3,-6,3,-4,0,0,0,0
1112,2,0,H,2,0,50,2,0,8,1,2,1,2,8,1,5,4,-6,7,0,0,0,0
1112,2,1,H,1,1,51,1,0,6,4,3,4,7,11,7,5,-2,-4,2,0,0,0,0
1112,3,0,H,1,3,52,0,2,5,10,2,10,9,6,8,5,-3,3,-5,0,0,0,0
1112,1,2,A,3,2,53,2,1,10,6,1,6,6,10,3,9,6,-4,4,0,0,0,0
1112,0,0,D,3,3,54,2,2,10,11,1,11,7,1,7,8,1,6,-1,0,0,0,0
1112,0,0,D,3,1,55,2,0,10,5,1,5,4,4,5,8,3,0,5,0,0,0,0
1112,0,0,D,0,2,56,0,2,1,7,1,7,6,4,7,2,-5,2,-6,0,0,0,0
1112,0,0,D,2,3,57,1,2,8,11,2,11,9,3,5,6,1,6,-3,0,0,0,0
1112,0,0,D,2,1,58,2,1,7,3,1,3,3,9,8,9,1,-6,4,0,0,0,0
1112,2,1,H,2,2,59,1,0,8,8,2,8,6,4,6,7,1,2,0,0,0,0,0
1112,0,2,A,1,0,60,1,0,5,1,2,1,2,10,10,10,0,-8,4,0,0,0,0
1112,2,2,D,2,1,61,2,1,8,9,1,6,7,8,4,6,2,-1,-1,0,0,0,0
1112,2,2,D,3,2,62,2,2,12,8,2,7,9,8,3,9,6,1,4,0,0,0,0
1112,0,2,A,0,2,63,0,1,4,11,1,8,9,7,10,4,-6,2,-7,0,0,0,0
1112,0,0,D,3,3,64,2,2,11,10,1,10,10,5,5,8,3,5,1,0,0,0,0
1112,1,0,H,1,2,65,0,1,4,9,1,8,6,5,13,8,-5,1,-5,0,0,0,0
1112,3,4,A,1,1,66,1,0,4,8,0,5,8,8,9,3,-6,0,-4,0,0,0,0
1112,1,2,A,2,3,67,1,2,9,11,0,10,8,7,11,8,-3,1,-2,0,0,0,0
1112,1,0,H,2,3,68,0,2,8,10,2,10,9,9,6,7,1,0,-2,0,0,0,0
1112,2,0,H,1,0,69,0,0,6,2,2,1,2,7,4,4,0,-5,4,0,0,0,0
1112,3,0,H,3,1,70,2,1,12,5,2,5,10,12,1,7,6,-2,7,0,0,0,0
1112,2,1,H,3,2,71,2,2,13,9,2,7,8,6,5,11,6,2,4,0,0,0,0
1112,1,1,D,3,1,72,2,0,14,7,1,4,9,13,8,10,2,-4,7,0,0,0,0
1112,1,1,D,0,3,73,0,2,2,12,1,10,8,5,9,2,-7,3,-10,0,0,0,0
1112,0,1,A,2,0,74,1,0,9,4,2,1,4,12,6,6,0,-8,5,0,0,0,0
1112,2,1,H,2,2,75,2,0,9,11,1,8,8,6,10,11,1,2,-2,0,0,0,0
1112,1,1,D,2,1,76,1,1,14,10,2,6,9,10,7,11,4,-1,4,0,0,0,0
1112,4,1,H,1,2,77,0,1,11,9,2,6,9,13,11,12,1,-4,2,0,0,0,0
1112,2,0,H,3,3,78,2,2,11,15,1,11,10,1,5,10,5,9,-4,0,0,0,0
1112,1,1,D,1,1,79,1,0,5,9,2,5,6,4,15,10,-5,2,-4,0,0,0,0
1112,2,0,H,3,1,80,2,1,10,4,1,3,6,13,10,9,-1,-7,6,0,0,0,0
1112,2,1,H,1,3,81,1,2,11,14,3,10,12,5,11,10,-1,7,-3,0,0,0,0
1112,1,2,A,1,3,82,0,2,8,16,1,11,13,6,14,10,-4,7,-8,0,0,0,0
1112,2,3,A,2,1,83,0,0,11,14,2,5,16,12,8,9,1,4,-3,0,0,0,0
1112,3,1,H,0,3,84,0,2,7,15,1,10,11,9,12,5,-7,2,-8,0,0,0,0
1112,0,3,A,3,2,85,2,1,13,15,1,8,12,8,6,9,3,4,-2,0,0,0,0
1112,1,0,H,2,2,86,2,2,9,12,1,7,13,11,8,9,1,2,-3,0,0,0,0
1112,1,1,D,1,1,87,1,1,4,6,0,5,11,16,15,6,-9,-5,-2,0,0,0,0
1112,2,0,H,2,0,88,1,0,9,3,0,1,3,10,17,10,-7,-7,6,0,0,0,0
1112,4,1,H,1,2,89,0,1,10,9,2,8,6,7,5,7,2,-1,1,0,0,0,0
1112,1,0,H,3,3,90,2,2,15,13,2,10,11,10,3,10,7,1,2,0,0,0,0
1112,0,2,A,1,2,91,1,0,7,11,2,8,11,11,17,12,-5,0,-4,0,0,0,0
1112,3,1,H,3,0,92,2,0,13,10,1,1,8,13,11,11,0,-5,3,0,0,0,0
1112,1,0,H,3,3,93,2,2,15,13,1,10,9,9,12,12,0,0,2,0,0,0,0
1112,0,1,A,0,1,94,0,1,3,5,1,3,7,16,12,3,-9,-9,-2,0,0,0,0
1112,1,0,H,2,2,95,1,2,9,12,2,7,10,8,11,7,-4,2,-3,0,0,0,0
1112,1,0,H,2,2,96,1,1,18,12,2,6,12,17,8,15,7,-5,6,0,0,0,0
1112,4,0,H,1,1,97,0,1,17,14,2,6,12,12,14,19,5,0,3,0,0,0,0
1112,2,1,H,3,1,98,2,0,18,13,2,5,11,6,3,11,8,5,5,0,0,0,0
1112,0,0,D,2,1,99,2,0,12,20,1,5,23,14,9,10,1,9,-8,0,0,0,0
1112,2,1,H,1,3,100,0,2,8,13,1,10,9,10,16,11,-5,-1,-5,0,0,0,0
1112,0,0,D,3,2,101,2,1,14,21,1,8,16,8,7,13,6,8,-7,0,0,0,0
1112,0,1,A,0,0,102,0,0,10,3,1,1,3,13,16,9,-7,-10,7,0,0,0,0
1112,1,2,A,1,2,103,1,1,14,12,3,8,8,11,16,12,-4,-3,2,0,0,0,0
1112,1,0,H,2,1,104,2,1,12,7,1,5,12,19,12,13,1,-7,5,0,0,0,0
1112,3,0,H,3,3,105,2,2,19,16,2,10,14,12,7,15,8,2,3,0,0,0,0
1112,2,0,H,2,3,106,1,2,12,21,0,11,13,4,18,12,-6,9,-9,0,0,0,0
1112,2,1,H,2,1,107,0,1,14,8,2,3,8,16,11,13,2,-8,6,0,0,0,0
1112,2,2,D,1,3,108,0,2,13,18,2,10,13,12,8,12,4,1,-5,0,0,0,0
1112,2,0,H,3,2,109,2,0,21,17,2,8,15,12,6,13,7,3,4,0,0,0,0
1112,1,1,D,3,3,110,2,2,19,15,1,10,13,7,14,15,1,6,4,0,0,0,0
1112,0,1,A,2,3,111,1,2,22,22,2,11,18,7,8,16,8,11,0,0,0,0,0
1112,0,1,A,1,1,112,1,1,8,14,0,6,13,18,18,9,-9,-5,-6,0,0,0,0
1112,2,1,H,1,2,113,1,1,7,15,2,6,14,18,20,12,-8,-4,-8,0,0,0,0
1112,1,1,D,3,0,114,2,0,13,10,1,1,9,17,12,10,-2,-8,3,0,0,0,0
1112,2,0,H,0,2,115,0,2,6,15,1,7,14,12,13,4,-9,2,-9,0,0,0,0
1112,4,0,H,1,2,116,0,1,21,15,2,8,10,12,14,23,9,-2,6,0,0,0,0
1112,2,0,H,3,2,117,2,2,16,13,1,7,10,9,15,14,-1,1,3,0,0,0,0
1112,0,1,A,1,1,118,0,0,14,11,2,4,13,17,10,14,4,-4,3,0,0,0,0
1112,3,3,D,3,3,119,2,2,16,25,1,11,19,7,8,14,6,12,-9,0,0,0,0
1112,0,2,A,2,1,120,2,0,15,24,1,5,27,14,14,14,0,13,-9,0,0,0,0
1112,0,1,A,1,3,121,0,2,14,24,1,11,15,6,17,14,-3,9,-10,0,0,0,0
1112,4,2,H,3,1,122,2,1,17,8,1,3,9,19,11,17,6,-10,9,0,0,0,0
1112,1,0,H,0,1,123,0,0,11,14,1,5,14,11,18,10,-8,3,-3,0,0,0,0
1112,0,1,A,1,3,124,1,2,17,14,3,10,11,13,18,14,-4,-2,3,0,0,0,0
1112,0,0,D,2,3,125,1,2,15,20,2,10,16,15,16,10,-6,1,-5,0,0,0,0
1112,3,0,H,2,2,126,2,0,13,17,1,8,15,14,11,10,-1,1,-4,0,0,0,0
1112,2,0,H,3,0,127,2,0,26,9,2,1,6,13,10,22,12,-7,17,0,0,0,0
1112,0,0,D,2,3,128,1,2,15,19,0,10,16,15,20,15,-5,1,-4,0,0,0,0
1112,3,0,H,2,1,129,1,1,22,10,2,5,14,21,9,16,7,-7,12,0,0,0,0
1112,2,0,H,1,2,130,0,2,14,16,1,7,13,11,18,14,-4,2,-2,0,0,0,0
1112,2,3,A,1,2,131,1,1,8,25,0,8,19,9,23,11,-12,10,-17,0,0,0,0
1112,0,1,A,3,0,132,2,0,20,9,1,1,6,15,15,16,1,-9,11,0,0,0,0
1112,0,2,A,1,2,133,0,2,14,15,2,7,14,16,12,14,2,-2,-1,0,0,0,0
1112,1,1,D,3,1,134,2,1,21,17,1,6,14,19,15,16,1,-5,4,0,0,0,0
1112,2,2,D,0,1,135,0,0,14,27,1,5,29,14,18,11,-7,15,-13,0,0,0,0
1112,0,0,D,3,2,136,2,1,17,16,1,6,15,20,13,12,-1,-5,1,0,0,0,0
1112,1,1,D,1,3,137,1,2,10,20,2,10,21,13,24,14,-10,8,-10,0,0,0,0
1112,2,1,H,3,2,138,2,1,27,16,2,8,10,16,6,16,10,-6,11,0,0,0,0
1112,1,1,D,2,3,139,0,2,17,29,2,11,24,10,17,15,-2,14,-12,0,0,0,0
1112,0,1,A,2,1,140,2,0,18,17,1,4,16,18,16,16,0,-2,1,0,0,0,0
1112,2,0,H,2,3,141,1,2,16,18,2,10,12,13,18,11,-7,-1,-2,0,0,0,0
1112,2,2,D,2,3,142,2,2,16,22,1,10,17,16,13,13,0,1,-6,0,0,0,0
1112,2,0,H,1,1,143,0,0,28,14,2,5,14,14,16,31,15,0,14,0,0,0,0
1112,2,0,H,1,3,144,1,2,18,20,3,10,16,16,20,15,-5,0,-2,0,0,0,0
1112,0,1,A,0,1,145,0,0,12,20,1,4,17,18,15,7,-8,-1,-8,0,0,0,0
1112,2,1,H,2,0,146,2,0,18,15,1,1,13,20,17,16,-1,-7,3,0,0,0,0
1112,2,0,H,3,1,147,2,1,30,11,2,5,15,25,11,25,14,-10,19,0,0,0,0
1112,2,2,D,2,3,148,1,2,28,30,2,11,18,7,11,22,11,11,-2,0,0,0,0
1112,1,3,A,3,2,149,2,0,21,18,1,8,16,18,14,22,8,-2,3,0,0,0,0
1112,3,3,D,2,1,150,1,1,17,8,0,3,13,26,20,15,-5,-13,9,0,0,0,0
1112,0,2,A,3,1,151,2,0,18,31,1,5,33,16,15,12,-3,17,-13,0,0,0,0
1112,0,0,D,1,2,152,0,2,14,17,2,7,15,15,16,14,-2,0,-3,0,0,0,0
1112,4,1,H,3,0,153,2,0,23,12,1,1,7,16,18,19,1,-9,11,0,0,0,0
1112,0,2,A,0,2,154,0,0,15,21,1,8,19,19,22,14,-8,0,-6,0,0,0,0
1112,4,1,H,1,1,155,0,1,23,9,1,3,16,29,18,18,0,-13,14,0,0,0,0
1112,0,0,D,2,2,156,1,1,29,19,2,8,13,18,13,24,11,-5,10,0,0,0,0
1112,6,1,H,3,2,157,2,2,21,21,1,7,18,18,17,23,6,0,0,0,0,0,0
1112,2,2,D,1,3,158,1,2,11,20,2,10,16,18,27,15,-12,-2,-9,0,0,0,0
1112,3,3,D,2,1,159,1,1,18,21,0,6,17,20,23,18,-5,-3,-3,0,0,0,0
1112,0,0,D,3,3,160,2,2,31,33,2,11,27,11,9,20,11,16,-2,0,0,0,0
1112,5,0,H,1,2,161,0,1,26,19,1,6,21,26,19,22,3,-5,7,0,0,0,0
1112,4,0,H,1,2,162,0,1,15,30,2,8,24,13,16,14,-2,11,-15,0,0,0,0
1112,0,2,A,3,1,163,2,0,26,34,1,5,35,16,19,23,4,19,-8,0,0,0,0
1112,2,0,H,0,1,164,0,1,15,22,1,6,20,23,24,14,-10,-3,-7,0,0,0,0
1112,3,0,H,3,2,165,2,2,18,21,1,7,19,24,17,12,-5,-5,-3,0,0,0,0
1112,0,1,A,1,3,166,1,2,9,34,0,11,27,11,33,17,-16,16,-25,0,0,0,0
1112,0,3,A,1,2,167,1,2,12,18,2,7,15,15,29,17,-12,0,-6,0,0,0,0
1112,1,3,A,3,3,168,2,2,21,24,1,10,29,18,20,18,-2,11,-3,0,0,0,0
1112,2,0,H,2,2,169,0,1,24,20,2,8,13,18,19,21,2,-5,4,0,0,0,0
1112,4,1,H,3,0,170,2,0,32,12,2,1,8,20,9,20,11,-12,20,0,0,0,0
1112,3,1,H,0,1,171,0,1,12,12,1,5,17,32,24,9,-15,-15,0,0,0,0,0
1112,1,0,H,2,3,172,1,2,20,21,2,10,19,23,20,13,-7,-4,-1,0,0,0,0
1112,0,1,A,2,1,173,2,1,21,9,1,3,17,34,15,18,3,-17,12,0,0,0,0
1112,3,2,H,2,3,174,2,2,21,35,1,11,24,10,27,19,-8,14,-14,0,0,0,0
1112,1,1,D,3,3,175,2,2,37,21,2,10,15,17,11,28,17,-2,16,0,0,0,0
1112,2,0,H,2,3,176,1,2,30,26,2,10,23,21,17,24,7,2,4,0,0,0,0
1112,0,1,A,1,1,177,0,0,37,29,2,4,27,19,16,37,21,8,8,0,0,0,0
1112,3,1,H,2,1,178,1,0,19,18,0,5,18,16,31,21,-10,2,1,0,0,0,0
1112,1,1,D,3,0,179,2,0,27,18,1,1,16,24,19,32,13,-8,9,0,0,0,0
1112,0,2,A,3,3,180,2,2,26,38,1,11,29,12,23,23,0,17,-12,0,0,0,0
1112,5,1,H,2,0,181,0,0,27,15,2,1,12,25,19,23,4,-13,12,0,0,0,0
1112,0,0,D,0,2,182,0,1,19,22,1,6,24,32,25,17,-8,-8,-3,0,0,0,0
1112,0,0,D,3,2,183,2,2,22,21,1,7,18,16,18,16,-2,2,1,0,0,0,0
1112,2,1,H,1,2,184,0,1,32,33,1,8,26,17,19,28,9,9,-1,0,0,0,0
1112,2,2,D,1,2,185,1,1,12,23,0,8,14,20,34,18,-16,-6,-11,0,0,0,0
1112,0,3,A,1,1,186,1,0,12,37,2,5,37,17,35,18,-17,20,-25,0,0,0,0
1112,5,3,H,3,2,187,2,2,21,24,1,7,22,29,24,19,-5,-7,-3,0,0,0,0
1112,1,1,D,1,3,188,0,2,18,28,2,10,33,20,19,19,0,13,-10,0,0,0,0
1112,2,1,H,3,1,189,2,1,35,22,2,6,20,25,13,26,13,-5,13,0,0,0,0
1112,1,1,D,1,2,190,1,1,22,23,3,6,24,32,27,21,-6,-8,-1,0,0,0,0
1112,2,1,H,3,3,191,2,2,41,38,2,11,28,14,12,31,19,14,3,0,0,0,0
1112,0,1,A,0,3,192,0,2,15,26,1,10,23,25,30,13,-17,-2,-11,0,0,0,0
1112,0,3,A,2,2,193,1,1,24,33,2,8,27,19,22,16,-6,8,-9,0,0,0,0
1112,2,1,H,2,1,194,2,0,22,19,1,5,20,20,16,18,2,0,3,0,0,0,0
1112,3,2,H,2,3,195,2,2,24,29,1,10,34,21,34,25,-9,13,-5,0,0,0,0
1112,1,0,H,1,1,196,1,0,13,35,0,4,30,20,36,20,-16,10,-22,0,0,0,0
1112,3,0,H,1,3,197,0,2,40,23,2,10,16,18,17,40,23,-2,17,0,0,0,0
1112,2,0,H,3,1,198,2,1,24,12,1,5,18,38,27,24,-3,-20,12,0,0,0,0
1112,1,1,D,2,0,199,0,0,30,20,2,1,17,25,20,28,8,-8,10,0,0,0,0
1112,4,2,H,3,2,200,2,0,23,31,1,8,29,21,21,16,-5,8,-8,0,0,0,0
1112,4,4,D,1,3,201,0,2,35,27,4,10,26,27,21,30,9,-1,8,0,0,0,0
1112,2,0,H,2,1,202,1,0,36,43,2,5,43,17,19,30,11,26,-7,0,0,0,0
1112,0,0,D,3,0,203,2,0,29,15,1,1,13,31,24,36,12,-18,14,0,0,0,0
1112,2,1,H,3,1,204,2,1,38,16,2,3,21,36,16,29,13,-15,22,0,0,0,0
1112,1,2,A,1,2,205,1,1,12,24,2,8,16,25,40,18,-22,-9,-12,0,0,0,0
1112,4,0,H,2,1,206,0,0,31,36,2,4,34,25,25,31,6,9,-5,0,0,0,0
1112,1,2,A,2,2,207,1,1,27,24,5,6,25,33,26,18,-8,-8,3,0,0,0,0
1112,3,2,H,2,3,208,2,2,25,41,4,11,31,17,17,20,3,14,-16,0,0,0,0
1112,3,2,H,2,2,209,2,1,27,39,1,8,32,19,36,28,-8,13,-12,0,0,0,0
1112,0,0,D,3,1,210,2,0,44,19,2,5,21,22,13,33,20,-1,25,0,0,0,0
1112,0,0,D,1,0,211,1,0,16,21,0,1,18,26,38,22,-16,-8,-5,0,0,0,0
1112,0,0,D,1,3,212,0,2,43,30,5,10,36,24,19,43,24,12,13,0,0,0,0
1112,0,0,D,1,3,213,1,2,12,26,5,10,20,23,42,19,-23,-3,-14,0,0,0,0
1112,2,1,H,3,3,214,2,2,28,29,4,10,24,25,31,30,-1,-1,-1,0,0,0,0
1112,1,1,D,1,2,215,1,0,23,34,3,8,35,25,28,22,-6,10,-11,0,0,0,0
1112,3,2,H,2,0,216,1,0,39,16,2,1,13,31,22,34,12,-18,23,0,0,0,0
1112,2,1,H,3,3,217,2,2,27,31,4,10,32,32,23,20,-3,0,-4,0,0,0,0
1112,1,2,A,3,1,218,2,0,41,44,2,5,43,19,20,33,13,24,-3,0,0,0,0
1112,0,0,D,3,1,219,2,1,29,17,1,3,22,38,27,25,-2,-16,12,0,0,0,0
1112,4,0,H,1,2,220,1,2,24,30,6,7,31,38,29,23,-6,-7,-6,0,0,0,0
1112,0,1,A,1,1,221,0,1,36,13,4,5,19,42,29,34,5,-23,23,0,0,0,0
1112,2,0,H,3,2,222,2,1,31,27,4,8,19,28,24,36,12,-9,4,0,0,0,0
1112,1,0,H,1,2,223,0,0,20,35,2,8,36,26,22,21,-1,10,-15,0,0,0,0
1112,1,0,H,3,2,224,2,2,30,30,1,7,31,42,27,25,-2,-11,0,0,0,0,0
1112,0,0,D,2,3,225,1,2,27,45,3,11,33,13,34,27,-7,20,-18,0,0,0,0
1112,0,3,A,2,3,226,2,2,28,34,1,10,38,24,19,23,4,14,-6,0,0,0,0
1112,0,3,A,1,0,227,0,0,36,22,1,1,18,26,30,34,4,-8,14,0,0,0,0
1112,3,1,H,3,1,228,2,1,46,27,2,6,27,29,13,33,20,-2,19,0,0,0,0
1112,1,3,A,0,1,229,0,0,16,47,4,5,45,20,34,15,-19,25,-31,0,0,0,0
1112,0,1,A,2,2,230,2,1,30,27,4,8,19,30,43,31,-12,-11,3,0,0,0,0
1112,4,1,H,1,1,231,1,0,18,23,3,5,22,22,38,22,-16,0,-5,0,0,0,0
1112,0,0,D,1,3,232,1,2,16,33,5,10,26,27,42,20,-22,-1,-17,0,0,0,0
1112,5,1,H,3,2,233,2,1,31,42,1,8,37,24,34,33,-1,13,-11,0,0,0,0
1112,1,0,H,2,2,234,0,1,35,28,2,6,27,34,27,36,9,-7,7,0,0,0,0
1112,0,0,D,3,3,235,2,2,41,30,2,10,22,24,22,34,12,-2,11,0,0,0,0
1112,2,0,H,0,2,236,0,2,25,28,4,7,23,22,26,21,-5,1,-3,0,0,0,0
1112,0,1,A,1,1,237,0,1,23,27,2,6,28,32,26,23,-3,-4,-4,0,0,0,0
1112,2,2,D,2,2,238,2,1,30,28,4,6,27,35,44,31,-13,-8,2,0,0,0,0
1112,1,1,D,1,3,239,0,2,50,49,5,11,36,14,21,48,27,22,1,0,0,0,0
1112,4,1,H,3,2,240,2,0,34,38,4,8,37,27,27,26,-1,10,-4,0,0,0,0
1112,1,3,A,0,3,241,0,2,28,42,4,11,34,22,26,23,-3,12,-14,0,0,0,0
1112,1,2,A,3,1,242,2,1,31,21,1,3,26,39,24,22,-2,-13,10,0,0,0,0
1112,3,1,H,1,1,243,1,1,30,17,3,5,20,42,32,29,-3,-22,13,0,0,0,0
1112,1,0,H,2,0,244,1,0,30,16,2,1,16,37,30,20,-10,-21,14,0,0,0,0
1112,1,0,H,2,2,245,1,2,42,28,2,7,23,24,29,38,9,-1,14,0,0,0,0
1112,1,0,H,3,1,246,2,0,37,36,1,4,34,33,24,41,17,1,1,0,0,0,0
1112,4,1,H,1,3,247,0,2,23,34,5,10,38,35,27,23,-4,3,-11,0,0,0,0
1112,1,1,D,3,2,248,2,1,50,33,2,8,21,30,15,37,22,-9,17,0,0,0,0
1112,0,4,A,3,1,249,2,0,34,51,1,5,49,22,39,39,0,27,-17,0,0,0,0
1112,1,0,H,0,1,250,0,1,28,17,1,5,21,45,29,24,-5,-24,11,0,0,0,0
1112,2,0,H,2,0,251,2,0,28,16,1,1,16,38,25,23,-2,-22,12,0,0,0,0
1112,2,2,D,1,1,252,0,1,36,33,1,6,32,33,34,34,0,-1,3,0,0,0,0
1112,2,2,D,1,2,253,1,2,24,31,0,7,33,46,40,28,-12,-13,-7,0,0,0,0
1112,1,2,A,2,3,254,1,2,29,40,0,10,42,24,37,29,-8,18,-11,0,0,0,0
1112,1,2,A,2,2,255,0,1,38,45,2,8,39,29,31,38,7,10,-7,0,0,0,0
1112,3,0,H,1,3,256,0,2,26,31,2,10,23,26,28,27,-1,-3,-5,0,0,0,0
1112,0,0,D,3,3,257,2,2,45,37,2,10,30,28,23,37,14,2,8,0,0,0,0
1112,1,1,D,0,3,258,0,2,31,51,1,11,38,16,29,25,-4,22,-20,0,0,0,0
1112,0,0,D,0,1,259,0,1,16,34,4,6,34,35,40,16,-24,-1,-18,0,0,0,0
1112,2,2,D,2,2,260,1,2,29,31,3,7,25,25,39,30,-9,0,-2,0,0,0,0
1112,0,2,A,2,1,261,1,0,34,37,2,4,36,36,31,22,-9,0,-3,0,0,0,0
1112,6,3,H,3,3,262,2,2,43,31,1,10,23,29,25,44,19,-6,12,0,0,0,0
1112,0,1,A,3,2,263,2,0,34,38,1,8,39,33,43,39,-4,6,-4,0,0,0,0
1112,1,1,D,3,2,264,2,1,38,30,1,6,32,41,28,30,2,-9,8,0,0,0,0
1112,1,0,H,1,2,265,1,2,35,32,3,7,27,27,35,34,-1,0,3,0,0,0,0
1112,0,2,A,0,1,266,0,0,17,29,1,5,30,28,40,16,-24,2,-12,0,0,0,0
1112,0,0,D,2,3,267,2,2,32,52,1,11,39,17,48,35,-13,22,-20,0,0,0,0
1112,1,3,A,2,0,268,1,0,48,32,2,1,26,30,30,41,11,-4,16,0,0,0,0
1112,2,0,H,1,1,269,0,1,54,25,2,3,30,42,22,53,31,-12,29,0,0,0,0
1112,1,0,H,1,3,270,1,2,17,46,2,11,37,23,46,21,-25,14,-29,0,0,0,0
1112,0,5,A,2,3,271,2,2,32,53,1,11,39,17,28,27,-1,22,-21,0,0,0,0
1112,0,2,A,2,1,272,1,0,31,57,0,5,55,22,42,33,-9,33,-26,0,0,0,0
1112,2,2,D,0,2,273,0,1,35,34,1,8,22,33,31,29,-2,-11,1,0,0,0,0
1112,3,0,H,3,0,274,2,0,31,17,1,1,16,42,35,26,-9,-26,14,0,0,0,0
1112,1,0,H,1,2,275,1,1,38,48,3,8,42,33,35,35,0,9,-10,0,0,0,0
1112,0,0,D,1,3,276,0,2,40,39,1,10,31,29,36,38,2,2,1,0,0,0,0
1112,1,1,D,1,3,277,1,2,25,34,0,10,39,44,44,30,-14,-5,-9,0,0,0,0
1112,0,2,A,1,1,278,0,1,32,20,2,5,22,46,28,32,4,-24,12,0,0,0,0
1112,2,2,D,3,3,279,2,2,46,46,2,10,50,28,24,37,13,22,0,0,0,0,0
1112,1,0,H,2,2,280,0,2,41,33,2,7,35,48,33,40,7,-13,8,0,0,0,0
1112,2,1,H,1,2,281,0,0,60,44,2,8,41,33,22,57,35,8,16,0,0,0,0
1112,1,1,D,3,3,282,2,2,35,47,1,11,39,26,45,40,-5,13,-12,0,0,0,0
1112,2,0,H,3,0,283,2,0,40,36,1,1,31,33,29,31,2,-2,4,0,0,0,0
1112,2,2,D,0,2,284,0,1,17,31,1,6,33,44,45,16,-29,-11,-14,0,0,0,0
1112,1,1,D,2,1,285,1,0,35,32,2,5,32,30,35,24,-11,2,3,0,0,0,0
1112,2,2,D,2,2,286,2,2,33,32,1,7,27,33,49,35,-14,-6,1,0,0,0,0
1112,2,0,H,3,1,287,2,0,56,41,2,4,38,36,17,44,27,2,15,0,0,0,0
1112,1,0,H,2,3,288,1,2,48,34,2,10,29,35,34,42,8,-6,14,0,0,0,0
1112,2,2,D,3,1,289,2,1,47,41,1,6,36,35,30,52,22,1,6,0,0,0,0
1112,0,0,D,1,1,290,1,1,23,26,2,3,31,45,46,24,-22,-14,-3,0,0,0,0
1112,1,1,D,1,1,291,1,0,42,63,3,5,59,23,37,38,1,36,-21,0,0,0,0
1112,3,1,H,2,2,292,1,1,32,51,0,8,43,34,46,35,-11,9,-19,0,0,0,0
1112,1,3,A,0,3,293,0,2,36,36,1,10,41,46,35,31,-4,-5,0,0,0,0,0
1112,2,0,H,3,3,294,2,2,34,43,1,10,33,29,36,29,-7,4,-9,0,0,0,0
1112,1,2,A,2,2,295,2,1,33,36,1,8,25,36,35,29,-6,-11,-3,0,0,0,0
1112,5,4,H,1,2,296,0,2,41,34,1,7,37,51,38,38,0,-14,7,0,0,0,0
1112,3,0,H,3,3,297,2,2,59,48,2,10,54,32,17,46,29,22,11,0,0,0,0
1112,0,0,D,1,0,298,1,0,27,18,0,1,18,47,45,31,-14,-29,9,0,0,0,0
1112,5,2,H,2,1,299,0,1,44,24,2,5,24,46,35,42,7,-22,20,0,0,0,0
1112,1,0,H,1,3,300,0,2,33,48,2,11,40,27,31,33,2,13,-15,0,0,0,0
1112,1,2,A,3,1,301,2,0,43,36,1,5,34,31,31,33,2,3,7,0,0,0,0
1112,2,2,D,3,1,302,2,0,37,44,1,4,43,42,36,31,-5,1,-7,0,0,0,0
1112,0,0,D,0,0,303,0,0,19,36,1,1,32,38,47,18,-29,-6,-17,0,0,0,0
1112,3,2,H,2,1,304,1,1,39,43,2,6,39,38,37,27,-10,1,-4,0,0,0,0
1112,3,1,H,2,3,305,1,2,51,48,2,10,54,35,37,44,7,19,3,0,0,0,0
1112,4,2,H,1,2,306,1,0,28,47,0,8,47,37,45,31,-14,10,-19,0,0,0,0
1112,1,2,A,1,2,307,0,2,64,33,2,7,30,37,24,60,36,-7,31,0,0,0,0
1112,1,1,D,1,2,308,1,2,24,34,2,7,41,56,51,26,-25,-15,-10,0,0,0,0
1112,0,2,A,3,3,309,2,2,39,62,1,11,49,17,47,44,-3,32,-23,0,0,0,0
1112,3,1,H,3,2,310,2,1,48,35,2,6,38,47,28,40,12,-9,13,0,0,0,0
1112,0,1,A,2,1,311,1,0,42,64,2,5,61,26,39,30,-9,35,-22,0,0,0,0
1112,1,2,A,1,1,312,1,1,43,31,3,3,35,47,41,41,0,-12,12,0,0,0,0
1112,0,0,D,2,3,313,2,2,36,39,1,10,44,49,38,32,-6,-5,-3,0,0,0,0
1112,1,1,D,2,0,314,2,0,35,20,1,1,18,47,57,42,-15,-29,15,0,0,0,0
1112,2,1,H,1,1,315,0,0,45,39,1,5,36,32,44,45,1,4,6,0,0,0,0
1112,2,1,H,3,2,316,2,1,65,54,2,8,47,38,17,51,34,9,11,0,0,0,0
1112,1,3,A,3,3,317,2,2,48,43,1,10,34,33,38,55,17,1,5,0,0,0,0
1112,2,0,H,2,1,318,1,1,35,25,0,5,27,52,50,39,-11,-25,10,0,0,0,0
1112,3,1,H,2,3,319,0,2,47,51,2,11,43,29,41,49,8,14,-4,0,0,0,0
1112,1,0,H,0,3,320,0,2,37,38,1,10,33,38,38,32,-6,-5,-1,0,0,0,0
1112,2,0,H,1,3,321,1,2,43,46,3,10,37,34,43,42,-1,3,-3,0,0,0,0
1112,0,0,D,2,3,322,1,2,42,51,2,11,44,32,40,30,-10,12,-9,0,0,0,0
1112,2,0,H,3,1,323,2,1,48,25,1,5,27,54,41,56,15,-27,23,0,0,0,0
1112,3,0,H,2,3,324,1,2,38,38,0,10,33,39,50,41,-9,-6,0,0,0,0,0
1112,2,2,D,0,3,325,0,2,21,40,1,10,44,49,48,19,-29,-5,-19,0,0,0,0
1112,0,0,D,2,1,326,2,0,37,48,1,4,47,45,38,32,-6,2,-11,0,0,0,0
1112,1,4,A,2,1,327,2,0,36,39,1,5,37,34,58,43,-15,3,-3,0,0,0,0
1112,4,0,H,3,2,328,2,0,68,50,2,8,52,42,18,53,35,10,18,0,0,0,0
1112,1,1,D,2,1,329,1,1,54,34,2,3,37,48,40,48,8,-11,20,0,0,0,0
1112,1,1,D,1,0,330,0,0,67,40,2,1,33,38,26,62,36,-5,27,0,0,0,0
1112,1,0,H,3,2,331,2,1,46,43,1,8,30,40,36,37,1,-10,3,0,0,0,0
1112,3,0,H,3,1,332,2,1,38,46,1,6,44,43,42,33,-9,1,-8,0,0,0,0
1112,0,1,A,0,3,333,0,2,22,71,1,11,57,18,50,21,-29,39,-49,0,0,0,0
1112,0,2,A,1,3,334,1,2,35,51,0,10,58,41,49,38,-11,17,-16,0,0,0,0
1112,1,0,H,1,2,335,0,2,68,36,2,7,44,62,27,63,36,-18,32,0,0,0,0
1112,2,1,H,1,2,336,1,1,25,55,2,8,49,41,56,27,-29,8,-30,0,0,0,0
1112,1,2,A,3,2,337,2,1,41,41,1,6,44,50,51,46,-5,-6,0,0,0,0,0
1112,1,2,A,2,2,338,0,2,50,38,2,7,32,38,46,52,6,-6,12,0,0,0,0
1112,1,1,D,1,0,339,0,0,42,41,2,1,34,39,35,41,6,-5,1,0,0,0,0
1112,1,3,A,3,1,340,2,0,52,49,2,4,47,45,32,44,12,2,3,0,0,0,0
1112,0,0,D,3,2,341,2,1,41,43,1,8,30,41,42,36,-6,-11,-2,0,0,0,0
1112,1,1,D,3,1,342,2,1,41,46,1,6,44,46,53,47,-6,-2,-5,0,0,0,0
1112,2,2,D,2,3,343,0,2,50,54,2,10,60,41,48,53,5,19,-4,0,0,0,0
1112,2,0,H,3,2,344,2,2,49,41,1,7,34,39,36,38,2,-5,8,0,0,0,0
1112,3,2,H,0,2,345,0,2,42,36,1,7,44,63,40,35,-5,-19,6,0,0,0,0
1112,2,1,H,1,0,346,0,0,52,22,1,1,21,51,46,50,4,-30,30,0,0,0,0
1112,1,2,A,1,2,347,1,1,35,44,0,6,46,51,51,38,-13,-5,-9,0,0,0,0
1112,0,4,A,1,3,348,1,2,28,74,2,11,58,18,57,29,-28,40,-46,0,0,0,0
1112,1,4,A,1,1,349,0,0,43,71,2,5,64,27,36,42,6,37,-28,0,0,0,0
1112,2,0,H,3,2,350,2,1,52,55,2,8,50,43,35,45,10,7,-3,0,0,0,0
1112,0,0,D,2,2,351,1,0,44,51,2,8,55,50,41,30,-11,5,-7,0,0,0,0
1112,2,0,H,3,3,352,2,2,55,42,1,10,48,54,43,62,19,-6,13,0,0,0,0
1112,0,1,A,1,0,353,1,0,47,45,3,1,38,42,47,45,-2,-4,2,0,0,0,0
1112,0,1,A,0,3,354,0,2,22,55,1,11,47,35,53,22,-31,12,-33,0,0,0,0
1112,2,2,D,2,1,355,2,1,41,28,1,5,29,61,41,34,-7,-32,13,0,0,0,0
1112,2,1,H,2,3,356,2,2,36,42,1,10,36,42,66,46,-20,-6,-6,0,0,0,0
1112,1,1,D,3,1,357,2,1,77,35,2,3,39,53,18,62,44,-14,42,0,0,0,0
1112,1,1,D,2,1,358,1,0,55,43,2,5,43,40,45,50,5,3,12,0,0,0,0
1112,2,0,H,1,3,359,0,2,74,52,2,10,40,36,28,68,40,4,22,0,0,0,0
1112,3,1,H,2,1,360,1,0,47,55,0,4,52,47,52,48,-4,5,-8,0,0,0,0
1112,0,1,A,1,2,361,1,2,36,42,0,7,36,43,54,40,-14,-7,-6,0,0,0,0
1112,2,2,D,2,1,362,0,1,52,47,2,6,45,48,50,55,5,-3,5,0,0,0,0
1112,0,2,A,3,2,363,2,1,52,56,1,8,51,46,38,40,2,5,-4,0,0,0,0
1112,2,0,H,0,3,364,0,2,48,58,1,10,64,43,42,39,-3,21,-10,0,0,0,0
1112,0,2,A,3,3,365,2,2,42,78,1,11,63,19,44,37,-7,44,-36,0,0,0,0
1112,4,2,H,1,1,366,0,0,55,77,1,5,70,28,50,53,3,42,-22,0,0,0,0
1112,3,0,H,1,0,367,1,0,29,22,2,1,22,54,63,31,-32,-32,7,0,0,0,0
1112,4,4,D,3,2,368,2,1,42,45,1,8,30,41,56,48,-8,-11,-3,0,0,0,0
1112,0,2,A,1,2,369,0,1,44,50,2,6,51,53,41,44,3,-2,-6,0,0,0,0
1112,2,0,H,3,2,370,2,2,58,39,2,7,48,67,35,48,13,-19,19,0,0,0,0
1112,0,2,A,1,3,371,1,2,48,61,3,11,50,35,50,47,-3,15,-13,0,0,0,0
1112,2,3,A,0,2,372,0,0,22,53,1,8,57,52,57,22,-35,5,-31,0,0,0,0
1112,1,0,H,2,1,373,1,1,46,36,2,3,40,55,45,34,-11,-15,10,0,0,0,0
1112,0,0,D,2,3,374,2,2,45,42,1,10,37,46,43,37,-6,-9,3,0,0,0,0
1112,2,0,H,2,3,375,2,2,39,43,1,10,52,60,69,48,-21,-8,-4,0,0,0,0
1112,3,1,H,3,3,376,2,2,81,52,2,10,40,40,19,65,46,0,29,0,0,0,0
1112,3,1,H,2,1,377,1,0,59,58,2,4,57,52,46,53,7,5,1,0,0,0,0
1112,2,1,H,1,1,378,0,1,77,32,2,5,34,63,32,72,40,-29,45,0,0,0,0
1112,2,1,H,3,1,379,2,0,58,44,1,5,44,43,45,64,19,1,14,0,0,0,0
1112,1,0,H,2,0,380,1,0,53,51,0,1,41,42,53,53,0,-1,2,0,0,0,0
1213,2,1,H,0,0,381,0,0,0,0,0,0,0,0,0,0,0,0,0,0,0,0,0
1213,2,0,H,0,0,382,0,0,0,0,0,0,0,0,0,0,0,0,0,0,0,0,0
1213,0,1,A,0,0,383,0,0,0,0,0,0,0,0,0,0,0,0,0,0,0,0,0
1213,2,0,H,0,0,384,0,0,0,0,0,0,0,0,0,0,0,0,0,0,0,0,0
1213,2,0,H,0,0,385,0,0,0,0,0,0,0,0,0,0,0,0,0,0,0,0,0
1213,0,1,A,0,0,386,0,0,0,0,0,0,0,0,0,0,0,0,0,0,0,0,0
1213,0,3,A,0,0,387,0,0,0,0,0,0,0,0,0,0,0,0,0,0,0,0,0
1213,0,3,A,0,0,388,0,0,0,0,0,0,0,0,0,0,0,0,0,0,0,0,0
1213,2,2,D,0,0,389,0,0,0,0,0,0,0,0,0,0,0,0,0,0,0,0,0
1213,0,0,D,0,0,390,0,0,0,0,0,0,0,0,0,0,0,0,0,0,0,0,0
1213,1,3,A,0,0,391,0,0,0,0,0,0,0,1,2,0,-2,-1,0,0,0,0,0
1213,3,0,H,0,0,392,0,0,1,0,1,0,0,3,0,0,0,-3,1,0,0,0,0
1213,1,1,D,0,0,393,0,0,0,0,0,0,0,1,2,0,-2,-1,0,0,0,0,0
1213,3,2,H,0,1,394,0,1,1,3,1,3,2,0,2,2,0,2,-2,0,0,0,0
1213,1,3,A,1,0,395,1,0,3,1,0,1,2,2,0,3,3,0,2,0,0,0,0
1213,3,0,H,1,0,396,1,0,3,0,0,0,0,3,0,1,1,-3,3,0,0,0,0
1213,2,1,H,1,1,397,1,1,3,3,0,3,2,1,0,3,3,1,0,0,0,0,0
1213,2,0,H,0,1,398,0,1,0,3,0,3,2,0,2,0,-2,2,-3,0,0,0,0
1213,2,1,H,1,0,399,1,0,3,1,0,1,0,0,0,1,1,0,2,0,0,0,0
1213,1,4,A,0,1,400,0,1,0,3,0,3,2,0,2,1,-1,2,-3,0,0,0,0
1213,0,1,A,1,0,401,1,0,3,1,0,1,1,2,2,3,1,-1,2,0,0,0,0
1213,1,1,D,0,0,402,0,0,0,1,0,1,1,3,6,0,-6,-2,-1,0,0,0,0
1213,1,3,A,1,2,403,1,2,3,6,0,6,4,0,2,2,0,4,-3,0,0,0,0
1213,2,0,H,1,1,404,1,1,3,4,0,4,5,4,3,3,0,1,-1,0,0,0,0
1213,1,3,A,1,2,405,1,2,3,6,0,6,6,1,3,4,1,5,-3,0,0,0,0
1213,3,1,H,2,1,406,2,1,6,3,0,3,2,2,1,5,4,0,3,0,0,0,0
1213,2,3,A,0,2,407,0,2,0,6,0,6,3,1,6,0,-6,2,-6,0,0,0,0
1213,2,3,A,1,0,408,1,0,4,0,1,0,1,5,3,5,2,-4,4,0,0,0,0
1213,2,2,D,0,0,409,0,0,1,0,1,0,2,6,2,1,-1,-4,1,0,0,0,0
1213,0,2,A,1,1,410,1,1,4,3,1,3,4,3,0,3,3,1,1,0,0,0,0
1213,2,0,H,3,1,411,3,1,9,3,0,3,3,5,2,9,7,-2,6,0,0,1,0
1213,1,1,D,1,2,412,1,2,3,6,0,6,5,3,5,3,-2,2,-3,0,0,0,0
1213,1,0,H,1,0,413,1,0,4,1,1,1,1,7,2,2,0,-6,3,0,0,0,0
1213,1,1,D,1,0,414,1,0,3,0,0,0,2,9,7,4,-3,-7,3,0,0,0,0
1213,0,3,A,0,1,415,0,1,2,4,2,4,7,6,4,2,-2,1,-2,0,0,0,0
1213,0,0,D,1,3,416,1,3,4,9,1,9,8,2,6,5,-1,6,-5,0,0,0,1
1213,0,2,A,2,0,417,2,0,6,2,0,2,3,4,3,6,3,-1,4,0,0,0,0
1213,0,1,A,3,1,418,3,1,9,3,0,3,5,6,1,7,6,-1,6,0,0,1,0
1213,1,1,D,3,1,419,3,1,9,4,0,4,3,2,3,6,3,1,5,0,0,1,0
1213,2,1,H,0,1,420,0,1,1,3,1,3,3,3,8,4,-4,0,-2,0,0,0,0
1213,0,0,D,2,4,421,2,3,7,12,1,12,11,2,4,6,2,9,-5,0,0,0,1
1213,2,1,H,1,2,422,1,1,5,7,2,7,3,2,6,5,-1,1,-2,0,0,0,0
1213,0,2,A,1,2,423,1,2,3,6,0,6,6,5,7,3,-4,1,-3,0,0,0,0
1213,1,1,D,2,1,424,1,1,6,4,0,4,4,6,6,6,0,-2,2,0,0,0,0
1213,2,0,H,1,0,425,1,0,3,2,0,2,2,7,5,4,-1,-5,1,0,0,0,0
1213,3,0,H,3,3,426,3,3,10,9,1,9,7,2,2,8,6,5,1,0,0,1,1
1213,1,0,H,0,0,427,0,0,1,1,1,1,1,8,10,3,-7,-7,0,0,0,0,0
1213,1,1,D,2,3,428,1,3,7,10,1,10,7,4,6,10,4,3,-3,0,0,0,1
1213,0,0,D,1,1,429,1,0,5,4,2,4,6,9,3,4,1,-3,1,0,0,0,0
1213,1,0,H,1,1,430,0,1,5,4,2,4,5,8,4,5,1,-3,1,0,0,0,0
1213,4,1,H,4,2,431,3,1,13,8,1,8,11,7,2,11,9,4,5,0,0,1,0
1213,1,1,D,1,2,432,1,1,5,6,2,6,6,5,7,5,-2,1,-1,0,0,0,0
1213,1,5,A,2,1,433,1,1,7,6,1,6,4,3,4,4,0,1,1,0,0,0,0
1213,4,0,H,1,2,434,1,1,4,8,1,8,7,7,9,5,-4,0,-4,0,0,0,0
1213,1,2,A,0,1,435,0,0,2,4,2,4,4,10,9,2,-7,-6,-2,0,0,0,0
1213,2,1,H,3,2,436,2,2,9,8,0,8,6,4,5,8,3,2,1,0,0,0,0
1213,2,1,H,3,2,437,3,0,9,8,0,8,6,4,5,7,2,2,1,0,0,1,0
1213,4,1,H,0,1,438,0,1,1,3,1,3,3,9,9,1,-8,-6,-2,0,0,0,0
1213,0,1,A,3,4,439,3,3,11,13,2,13,11,2,5,8,3,9,-2,0,0,1,1
1213,0,0,D,1,2,440,0,1,5,7,2,7,7,7,9,6,-3,0,-2,0,0,0,0
1213,2,1,H,1,3,441,1,3,3,11,0,11,8,6,13,4,-9,2,-8,0,0,0,1
1213,1,1,D,2,0,442,1,0,8,4,1,1,5,10,7,7,0,-5,4,0,0,0,0
1213,2,0,H,2,1,443,1,1,8,6,2,5,6,8,11,7,-4,-2,2,0,0,0,0
1213,1,0,H,2,1,444,2,1,8,7,2,4,9,9,6,7,1,0,1,0,0,0,0
1213,0,1,A,2,3,445,1,2,7,12,0,9,10,6,6,7,1,4,-5,0,0,0,0
1213,2,1,H,4,1,446,3,0,16,6,1,5,6,9,2,12,10,-3,10,0,0,1,0
1213,0,3,A,1,3,447,0,3,7,12,1,9,9,6,11,6,-5,3,-5,0,0,0,1
1213,2,0,H,2,2,448,1,1,8,7,2,7,5,9,11,12,1,-4,1,0,0,0,0
1213,1,2,A,2,4,449,0,3,8,16,2,13,15,3,6,7,1,12,-8,0,0,0,1
1213,0,1,A,1,0,450,1,0,9,2,3,2,3,11,4,9,5,-8,7,0,0,0,0
1213,2,0,H,4,4,451,3,3,19,19,1,13,14,3,4,17,13,11,0,0,0,1,1
1213,3,2,H,3,2,452,3,1,15,7,0,6,7,7,6,12,6,0,8,0,0,1,0
1213,2,1,H,2,2,453,1,0,7,8,1,8,8,8,11,5,-6,0,-1,0,0,0,0
1213,1,0,H,0,1,454,0,1,5,7,2,4,9,10,11,4,-7,-1,-2,0,0,0,0
1213,1,1,D,1,2,455,1,2,6,11,0,8,8,6,14,6,-8,2,-5,0,0,0,0
1213,2,4,A,2,2,456,1,1,9,11,1,8,14,11,8,8,0,3,-2,0,0,0,0
1213,2,0,H,3,2,457,2,1,15,11,0,8,9,11,6,11,5,-2,4,0,0,0,0
1213,0,0,D,0,1,458,0,1,5,9,1,6,9,5,11,6,-5,4,-4,0,0,0,0
1213,2,1,H,1,3,459,1,3,6,11,2,11,9,8,10,6,-4,1,-5,0,0,0,1
1213,1,0,H,1,1,460,0,0,6,7,2,4,6,14,11,7,-4,-8,-1,0,0,0,0
1213,1,0,H,2,2,461,1,1,7,9,0,7,10,12,10,9,-1,-2,-2,0,0,0,0
1213,0,0,D,2,0,462,0,0,8,6,2,1,6,11,10,9,-1,-5,2,0,0,0,0
1213,1,3,A,1,3,463,1,2,7,18,1,9,13,6,11,9,-2,7,-11,0,0,0,0
1213,0,1,A,2,4,464,1,3,11,22,2,13,19,4,13,9,-4,15,-11,0,0,0,1
1213,2,0,H,2,3,465,2,3,12,18,2,9,15,8,7,9,2,7,-6,0,0,0,1
1213,1,0,H,4,1,466,3,1,19,7,1,3,7,15,5,14,9,-8,12,0,0,1,0
1213,0,0,D,1,2,467,0,1,7,10,1,7,7,12,15,6,-9,-5,-3,0,0,0,0
1213,2,3,A,2,1,468,1,0,14,9,2,5,8,11,13,18,5,-3,5,0,0,0,0
1213,0,1,A,3,0,469,3,0,11,8,2,2,5,11,10,10,0,-6,3,0,0,1,0
1213,1,3,A,1,1,470,1,1,10,9,3,5,8,11,5,9,4,-3,1,0,0,0,0
1213,2,2,D,0,2,471,0,1,7,10,1,6,10,10,11,6,-5,0,-3,0,0,0,0
1213,1,0,H,2,4,472,1,3,11,22,1,13,15,5,12,7,-5,10,-11,0,0,0,1
1213,4,2,H,0,2,473,0,0,11,9,2,8,9,10,11,6,-5,-1,2,0,0,0,0
1213,2,0,H,1,1,474,1,0,7,8,0,4,6,15,16,7,-9,-9,-1,0,0,0,0
1213,3,2,H,3,3,475,2,3,21,11,0,11,10,11,7,16,9,-1,10,0,0,0,1
1213,2,1,H,4,1,476,3,1,25,7,1,4,10,14,4,20,16,-4,18,0,0,1,0
1213,1,1,D,3,1,477,3,1,18,10,0,6,10,8,10,15,5,2,8,0,0,1,0
1213,3,2,H,1,2,478,1,1,12,14,2,8,20,16,12,11,-1,4,-2,0,0,0,0
1213,2,2,D,1,2,479,0,1,12,11,2,8,9,14,13,11,-2,-5,1,0,0,0,0
1213,0,1,A,2,2,480,1,2,9,15,1,8,11,7,13,10,-3,4,-6,0,0,0,0
1213,1,3,A,4,3,481,3,2,28,24,1,9,19,9,5,22,17,10,4,0,0,1,0
1213,5,1,H,2,1,482,1,1,11,10,0,3,9,16,12,12,0,-7,1,0,0,0,0
1213,1,1,D,1,1,483,1,0,7,13,1,5,13,15,16,11,-5,-2,-6,0,0,0,0
1213,4,0,H,2,3,484,1,3,12,19,2,9,16,11,16,11,-5,5,-7,0,0,0,1
1213,4,1,H,2,0,485,2,0,18,14,2,2,10,13,7,12,5,-3,4,0,0,0,0
1213,1,1,D,4,1,486,3,1,22,11,1,6,11,9,6,15,9,2,11,0,0,1,0
1213,2,0,H,1,1,487,0,1,8,15,1,5,14,14,17,6,-11,0,-7,0,0,0,0
1213,4,1,H,2,0,488,1,0,14,8,2,1,8,13,19,22,3,-5,6,0,0,0,0
1213,1,2,A,3,2,489,3,1,11,14,2,7,8,12,14,12,-2,-4,-3,0,0,1,0
1213,1,0,H,2,2,490,0,1,9,9,2,7,10,14,14,11,-3,-4,0,0,0,0,0
1213,0,0,D,0,2,491,0,1,14,15,2,8,15,16,17,11,-6,-1,-1,0,0,0,0
1213,1,6,A,1,4,492,0,3,11,28,1,13,23,8,17,8,-9,15,-17,0,0,0,1
1213,3,2,H,2,3,493,1,2,17,27,1,9,22,10,13,10,-3,12,-10,0,0,0,0
1213,2,2,D,1,1,494,1,0,10,14,0,5,14,16,21,10,-11,-2,-4,0,0,0,0
1213,2,4,A,2,4,495,1,3,9,23,1,13,16,7,15,10,-5,9,-14,0,0,0,1
1213,3,2,H,3,2,496,3,1,19,17,0,8,26,20,15,16,1,6,2,0,0,1,0
1213,1,3,A,2,2,497,1,2,14,21,0,8,16,8,13,17,4,8,-7,0,0,0,0
1213,2,0,H,0,3,498,0,3,8,11,1,11,13,16,17,9,-8,-3,-3,0,0,0,1
1213,0,0,D,1,2,499,1,0,15,12,2,8,12,14,16,14,-2,-2,3,0,0,0,0
1213,1,0,H,1,1,500,1,1,12,8,3,4,12,17,10,12,2,-5,4,0,0,0,0
1213,0,0,D,4,3,501,3,3,31,22,1,9,19,17,9,29,20,2,9,0,0,1,1
1213,2,2,D,4,2,502,3,1,26,14,1,6,18,16,9,20,11,2,12,0,0,1,0
1213,3,0,H,1,0,503,1,0,8,11,1,1,11,17,18,12,-6,-6,-3,0,0,0,0
1213,2,1,H,2,1,504,1,1,16,11,2,3,12,23,16,15,-1,-11,5,0,0,0,0
1213,4,1,H,2,2,505,2,1,24,20,2,7,13,15,9,19,10,-2,4,0,0,0,0
1213,2,2,D,3,0,506,2,0,27,15,0,2,11,17,13,24,11,-6,12,0,0,0,0
1213,3,1,H,3,2,507,3,1,11,9,2,7,12,19,18,13,-5,-7,2,0,0,1,0
1213,1,0,H,2,1,508,0,0,13,11,2,4,9,23,14,12,-2,-14,2,0,0,0,0
1213,2,2,D,1,1,509,0,1,15,16,2,5,14,16,18,16,-2,-2,-1,0,0,0,0
1213,2,0,H,2,1,510,1,1,17,15,2,6,13,10,23,28,5,3,2,0,0,0,0
1213,3,1,H,0,2,511,0,1,11,19,1,8,17,17,20,11,-9,0,-8,0,0,0,0
1213,0,1,A,2,2,512,1,1,20,9,1,7,13,22,19,14,-5,-9,11,0,0,0,0
1213,0,0,D,1,2,513,1,0,11,16,0,8,13,14,25,13,-12,-1,-5,0,0,0,0
1213,1,0,H,2,4,514,1,3,15,32,0,13,29,9,18,20,2,20,-17,0,0,0,1
1213,0,1,A,1,2,515,0,1,11,20,1,8,30,23,24,9,-15,7,-9,0,0,0,0
1213,1,0,H,3,1,516,3,1,14,11,2,4,15,18,19,16,-3,-3,3,0,0,1,0
1213,2,2,D,1,2,517,1,2,15,27,3,8,23,10,12,13,1,13,-12,0,0,0,0
1213,0,1,A,0,4,518,0,3,16,27,2,13,22,11,19,13,-6,11,-11,0,0,0,1
1213,1,0,H,1,3,519,1,2,17,28,2,9,26,15,18,16,-2,11,-11,0,0,0,0
1213,3,0,H,3,1,520,3,0,23,16,0,5,18,20,17,19,2,-2,7,0,0,1,0
1213,1,3,A,2,2,521,1,1,19,18,2,6,21,18,20,18,-2,3,1,0,0,0,0
1213,3,0,H,4,1,522,3,1,32,16,1,6,15,14,10,29,19,1,16,0,0,1,0
1213,2,1,H,1,2,523,1,1,11,20,1,7,14,20,19,15,-4,-6,-9,0,0,0,0
1213,2,2,D,2,3,524,2,3,28,17,2,11,17,19,12,25,13,-2,11,0,0,0,1
1213,2,4,A,2,1,525,1,1,12,12,1,3,13,25,22,14,-8,-12,0,0,0,0,0
1213,1,0,H,3,0,526,2,0,28,14,0,1,14,21,16,26,10,-7,14,0,0,0,0
1213,2,1,H,3,1,527,3,1,26,20,0,5,17,18,17,22,5,-1,6,0,0,1,0
1213,5,1,H,4,1,528,3,0,30,11,1,4,9,25,11,23,12,-16,19,0,0,1,0
1213,1,3,A,2,2,529,0,1,17,23,2,8,31,23,14,13,-1,8,-6,0,0,0,0
1213,4,1,H,1,0,530,0,0,16,16,2,2,13,20,23,18,-5,-7,0,0,0,0,0
1213,2,1,H,2,1,531,1,1,20,20,1,5,18,20,22,15,-7,-2,0,0,0,0,0
1213,4,2,H,2,2,532,1,2,26,29,2,8,27,14,24,34,10,13,-3,0,0,0,0
1213,0,2,A,0,1,533,0,1,16,15,2,3,17,27,24,14,-10,-10,1,0,0,0,0
1213,2,1,H,3,4,534,2,3,31,33,0,13,28,12,16,27,11,16,-2,0,0,0,1
1213,0,1,A,0,4,535,0,3,14,35,1,13,32,10,22,14,-8,22,-21,0,0,0,1
1213,2,0,H,1,2,536,0,1,11,12,1,7,16,26,30,10,-20,-10,-1,0,0,0,0
1213,1,3,A,2,2,537,0,1,17,19,2,8,19,23,17,14,-3,-4,-2,0,0,0,0
1213,2,4,A,1,2,538,1,1,16,21,3,6,24,19,17,15,-2,5,-5,0,0,0,0
1213,0,0,D,1,3,539,1,3,14,29,1,9,24,18,20,17,-3,6,-15,0,0,0,1
1213,0,2,A,3,1,540,3,0,18,19,2,5,22,24,21,19,-2,-2,-1,0,0,1,0
1213,1,0,H,3,3,541,3,2,30,34,0,9,29,17,18,24,6,12,-4,0,0,1,0
1213,1,1,D,1,0,542,0,0,22,14,2,1,14,23,24,24,0,-9,8,0,0,0,0
1213,3,1,H,2,3,543,1,3,22,18,2,11,19,23,24,22,-2,-4,4,0,0,0,1
1213,1,0,H,1,2,544,1,1,18,29,0,8,38,26,27,19,-8,12,-11,0,0,0,0
1213,4,1,H,2,2,545,2,0,29,17,2,8,15,20,18,29,11,-5,12,0,0,0,0
1213,1,1,D,2,1,546,1,1,12,16,1,6,17,21,28,16,-12,-4,-4,0,0,0,0
1213,3,0,H,4,2,547,3,1,38,23,1,7,17,23,10,33,23,-6,15,0,0,1,0
1213,4,1,H,2,1,548,1,0,24,14,0,4,12,30,21,28,7,-18,10,0,0,0,0
1213,2,3,A,4,1,549,3,1,33,15,1,4,17,20,14,29,15,-3,18,0,0,1,0
1213,4,1,H,1,0,550,1,0,20,16,2,2,14,26,22,19,-3,-12,4,0,0,0,0
1213,1,3,A,0,4,551,0,3,16,41,2,13,36,10,30,15,-15,26,-25,0,0,0,1
1213,2,1,H,1,2,552,0,1,14,25,1,8,25,25,34,13,-21,0,-11,0,0,0,0
1213,1,1,D,2,1,553,1,0,23,23,1,5,25,25,26,17,-9,0,0,0,0,0,0
1213,1,2,A,1,1,554,1,1,18,23,1,5,23,23,22,20,-2,0,-5,0,0,0,0
1213,1,1,D,3,2,555,2,1,34,13,0,7,17,29,18,29,11,-12,21,0,0,0,0
1213,0,3,A,0,2,556,0,2,15,32,1,8,33,19,24,15,-9,14,-17,0,0,0,0
1213,4,2,H,2,2,557,1,1,29,27,2,6,32,22,27,38,11,10,2,0,0,0,0
1213,0,1,A,3,3,558,3,3,18,33,2,9,25,18,26,20,-6,7,-15,0,0,1,1
1213,0,2,A,2,4,559,0,3,17,33,2,13,31,17,24,16,-8,14,-16,0,0,0,1
1213,2,0,H,1,1,560,1,1,17,21,3,3,20,27,22,18,-4,-7,-4,0,0,0,0
1213,0,0,D,2,1,561,1,1,25,20,2,6,20,22,27,26,-1,-2,5,0,0,0,0
1213,2,1,H,3,0,562,3,0,36,16,0,2,16,33,18,26,8,-17,20,0,0,1,0
1213,1,0,H,1,2,563,1,1,21,24,0,7,18,27,29,20,-9,-9,-3,0,0,0,0
1213,0,2,A,2,1,564,2,0,35,17,2,4,15,35,19,36,17,-20,18,0,0,0,0
1213,2,0,H,2,1,565,1,1,14,18,1,4,21,24,30,18,-12,-3,-4,0,0,0,0
1213,1,2,A,4,3,566,3,3,44,18,1,11,20,27,11,39,28,-7,26,0,0,1,1
1213,2,1,H,2,2,567,1,0,27,17,0,8,16,26,26,34,8,-10,10,0,0,0,0
1213,4,1,H,4,2,568,3,1,36,32,1,8,42,29,17,33,16,13,4,0,0,1,0
1213,2,1,H,1,0,569,1,0,26,15,2,1,15,27,24,25,1,-12,11,0,0,0,0
1213,3,0,H,1,3,570,0,2,24,35,2,9,30,19,26,26,0,11,-11,0,0,0,0
1213,4,0,H,1,1,571,1,1,18,24,4,3,21,29,26,21,-5,-8,-6,0,0,0,0
1213,2,0,H,3,1,572,2,0,35,20,0,4,17,35,22,30,8,-18,15,0,0,0,0
1213,2,1,H,0,2,573,0,1,16,17,5,7,20,30,35,17,-18,-10,-1,0,0,0,0
1213,1,0,H,2,2,574,1,1,26,32,2,8,43,33,27,26,-1,10,-6,0,0,0,0
1213,2,0,H,3,2,575,3,1,39,24,0,7,18,28,19,28,9,-10,15,0,0,1,0
1213,3,0,H,4,0,576,3,0,39,15,1,1,16,29,18,37,19,-13,24,0,0,1,0
1213,1,1,D,1,4,577,1,3,29,44,5,13,40,13,25,27,2,27,-15,0,0,0,1
1213,0,0,D,3,2,578,3,1,21,30,2,6,36,27,28,22,-6,9,-9,0,0,1,0
1213,3,2,H,1,2,579,1,0,21,17,3,8,17,28,22,20,-2,-11,4,0,0,0,0
1213,3,1,H,1,2,580,0,2,27,35,5,8,36,21,26,29,3,15,-8,0,0,0,0
1213,4,0,H,4,1,581,3,0,45,30,1,5,32,27,14,41,27,5,15,0,0,1,0
1213,2,1,H,2,1,582,1,1,31,21,0,4,25,26,27,36,9,-1,10,0,0,0,0
1213,2,2,D,0,3,583,0,3,15,42,4,9,30,19,32,16,-16,11,-27,0,0,0,1
1213,1,1,D,2,0,584,1,0,24,19,1,2,19,36,30,18,-12,-17,5,0,0,0,0
1213,1,1,D,1,1,585,1,1,24,30,3,5,28,26,33,21,-12,2,-6,0,0,0,0
1213,1,1,D,2,4,586,2,3,35,42,5,13,40,18,24,37,13,22,-7,0,0,0,1
1213,0,2,A,2,2,587,1,1,17,29,4,8,27,27,32,21,-11,0,-12,0,0,0,0
1213,0,2,A,1,1,588,0,1,20,24,4,6,23,24,37,17,-20,-1,-4,0,0,0,0
1213,1,1,D,2,3,589,1,2,32,38,2,9,32,22,34,43,9,10,-6,0,0,0,0
1213,1,0,H,2,3,590,0,3,17,22,5,11,22,28,31,19,-12,-6,-5,0,0,0,1
1213,1,1,D,4,2,591,3,1,48,17,1,7,21,34,14,45,31,-13,31,0,0,1,0
1213,0,1,A,3,1,592,3,1,43,25,0,3,22,34,21,32,11,-12,18,0,0,1,0
1213,0,1,A,2,2,593,1,1,25,34,1,6,38,28,31,19,-12,10,-9,0,0,0,0
1213,3,3,D,1,2,594,1,1,21,33,1,8,44,35,28,26,-2,9,-12,0,0,0,0
1213,1,1,D,0,0,595,0,0,20,16,2,1,18,34,37,20,-17,-16,4,0,0,0,0
1213,2,1,H,2,2,596,1,2,32,36,5,8,38,25,27,29,2,13,-4,0,0,0,0
1213,2,2,D,3,1,597,2,1,39,27,0,6,25,24,23,33,10,1,12,0,0,0,0
1213,1,2,A,1,4,598,1,3,31,43,5,13,41,19,27,29,2,22,-12,0,0,0,1
1213,6,0,H,3,1,599,3,0,22,20,2,4,17,39,29,22,-7,-22,2,0,0,1,0
1213,1,0,H,1,2,600,0,0,30,20,2,8,20,31,31,32,1,-11,10,0,0,0,0
1213,2,4,A,2,0,601,1,0,34,21,2,2,21,38,38,47,9,-17,13,0,0,0,0
1213,2,0,H,4,2,602,3,1,46,35,1,8,31,28,20,43,23,3,11,0,0,1,0
1213,0,0,D,1,3,603,1,3,28,25,3,11,28,29,26,27,1,-1,3,0,0,0,1
1213,1,2,A,1,4,604,1,3,28,49,3,13,46,15,34,23,-11,31,-21,0,0,0,1
1213,2,0,H,2,1,605,2,1,36,31,2,5,30,29,27,39,12,1,5,0,0,0,0
1213,3,2,H,2,3,606,1,3,18,43,1,9,32,22,35,22,-13,10,-25,0,0,0,1
1213,2,1,H,2,1,607,1,0,37,33,3,5,33,31,28,39,11,2,4,0,0,0,0
1213,1,2,A,0,2,608,0,1,17,25,4,7,19,32,35,19,-16,-13,-8,0,0,0,0
1213,2,3,A,1,1,609,0,1,20,22,1,4,29,31,45,17,-28,-2,-2,0,0,0,0
1213,3,1,H,2,3,610,0,2,20,40,2,9,35,25,32,20,-12,10,-20,0,0,0,0
1213,2,0,H,4,2,611,3,2,52,39,1,8,41,27,16,48,32,14,13,0,0,1,0
1213,1,1,D,3,4,612,3,3,43,49,3,13,45,20,25,34,9,25,-6,0,0,1,1
1213,0,0,D,2,2,613,1,1,28,35,4,8,31,30,33,21,-12,1,-7,0,0,0,0
1213,1,1,D,1,2,614,1,0,25,23,4,8,23,33,33,32,-1,-10,2,0,0,0,0
1213,1,1,D,0,2,615,0,1,24,40,5,6,41,29,40,25,-15,12,-16,0,0,0,0
1213,3,1,H,3,1,616,2,1,40,28,0,3,24,36,28,36,8,-12,12,0,0,0,0
1213,1,1,D,0,1,617,0,0,17,20,4,4,19,48,37,20,-17,-29,-3,0,0,0,0
1213,0,0,D,1,2,618,1,1,31,21,2,7,25,37,31,30,-1,-12,10,0,0,0,0
1213,3,1,H,3,2,619,3,1,26,34,2,8,49,42,29,28,-1,7,-8,0,0,1,0
1213,1,0,H,1,1,620,0,1,33,29,2,6,27,26,33,34,1,1,4,0,0,0,0
1213,2,1,H,2,1,621,1,1,41,32,0,5,30,31,30,42,12,-1,9,0,0,0,0
1213,1,1,D,1,0,622,1,0,28,18,0,1,21,38,39,25,-14,-17,10,0,0,0,0
1213,1,0,H,2,4,623,1,3,34,55,2,13,50,16,45,50,5,34,-21,0,0,0,1
1213,1,0,H,2,1,624,1,1,36,26,2,4,33,34,30,31,1,-1,10,0,0,0,0
1213,4,1,H,2,3,625,2,2,39,43,2,9,39,29,29,41,12,10,-4,0,0,0,0
1213,1,0,H,2,1,626,1,0,22,36,1,5,35,33,37,25,-12,2,-14,0,0,0,0
1213,0,0,D,4,3,627,3,3,50,29,1,11,31,30,21,46,25,1,21,0,0,1,1
1213,0,2,A,1,0,628,0,0,21,25,1,2,26,41,49,20,-29,-15,-4,0,0,0,0
1213,2,1,H,1,2,629,1,1,29,29,3,7,21,33,27,27,0,-12,0,0,0,0,0
1213,3,0,H,2,3,630,0,3,24,44,2,9,35,26,34,24,-10,9,-20,0,0,0,1
1213,0,0,D,0,2,631,0,1,19,25,1,7,26,37,39,22,-17,-11,-6,0,0,0,0
1213,2,3,A,2,2,632,1,1,29,37,1,8,51,45,35,22,-13,6,-8,0,0,0,0
1213,4,3,H,0,1,633,0,1,28,32,2,6,29,28,41,28,-13,1,-4,0,0,0,0
1213,1,1,D,3,2,634,2,1,43,44,0,6,44,31,33,40,7,13,-1,0,0,0,0
1213,3,0,H,4,2,635,3,0,55,27,1,8,27,34,17,50,33,-7,28,0,0,1,0
1213,1,2,A,1,2,636,1,1,32,39,2,8,32,30,33,31,-2,2,-7,0,0,0,0
1213,2,0,H,3,1,637,3,1,30,29,2,3,26,40,30,31,1,-14,1,0,0,1,0
1213,2,0,H,3,1,638,3,0,44,21,0,4,20,51,29,35,6,-31,23,0,0,1,0
1213,0,0,D,1,4,639,0,3,36,51,2,13,46,21,34,35,1,25,-15,0,0,0,1
1213,2,1,H,1,2,640,1,2,26,42,1,8,45,30,35,33,-2,15,-16,0,0,0,0
1213,1,1,D,4,4,641,3,3,52,58,1,13,53,17,21,46,25,36,-6,0,0,1,1
1213,3,0,H,2,3,642,1,3,45,47,0,9,37,29,32,45,13,8,-2,0,0,0,1
1213,3,0,H,1,0,643,1,0,29,31,1,2,32,44,36,35,-1,-12,-2,0,0,0,0
1213,2,3,A,2,3,644,1,2,42,44,2,9,41,34,31,34,3,7,-2,0,0,0,0
1213,2,1,H,2,1,645,2,1,42,29,2,3,26,42,32,46,14,-16,13,0,0,0,0
1213,0,1,A,1,1,646,0,0,21,37,1,5,35,34,53,20,-33,1,-16,0,0,0,0
1213,3,1,H,2,2,647,1,1,40,26,2,7,26,37,47,54,7,-11,14,0,0,0,0
1213,1,0,H,3,1,648,3,1,33,32,2,5,32,35,30,33,3,-3,1,0,0,1,0
1213,0,2,A,2,2,649,0,1,27,29,2,7,24,38,37,27,-10,-14,-2,0,0,0,0
1213,0,0,D,1,0,650,1,0,32,20,3,1,22,39,32,32,0,-17,12,0,0,0,0
1213,0,2,A,2,2,651,1,1,26,48,1,6,48,32,40,27,-13,16,-22,0,0,0,0
1213,1,1,D,1,2,652,0,1,40,43,2,8,57,48,34,36,2,9,-3,0,0,0,0
1213,2,1,H,2,1,653,1,0,32,21,1,4,20,54,38,26,-12,-34,11,0,0,0,0
1213,3,1,H,0,3,654,0,3,31,36,2,11,34,30,47,32,-15,4,-5,0,0,0,1
1213,2,0,H,1,4,655,1,3,29,53,0,13,47,22,44,27,-17,25,-24,0,0,0,1
1213,0,1,A,3,1,656,2,1,47,32,0,4,38,36,36,44,8,2,15,0,0,0,0
1213,1,0,H,4,2,657,3,1,59,42,1,8,36,34,18,54,36,2,17,0,0,1,0
1213,0,2,A,3,2,658,3,2,47,45,0,8,48,33,32,37,5,15,2,0,0,1,0
1213,1,2,A,0,2,659,0,0,21,27,1,8,27,39,39,22,-17,-12,-6,0,0,0,0
1213,4,1,H,1,1,660,1,1,32,33,2,6,32,32,36,32,-4,0,-1,0,0,0,0
1213,0,2,A,1,4,661,1,3,35,62,1,13,55,18,36,39,3,37,-27,0,0,0,1
1213,3,1,H,2,1,662,1,0,42,41,2,5,37,35,35,36,1,2,1,0,0,0,0
1213,3,2,H,2,2,663,2,1,48,26,2,7,27,42,33,50,17,-15,22,0,0,0,0
1213,2,0,H,2,0,664,1,0,51,21,0,1,23,41,32,50,18,-18,30,0,0,0,0
1213,3,2,H,4,2,665,3,1,53,35,1,7,28,39,24,47,23,-11,18,0,0,1,0
1213,0,2,A,1,1,666,0,1,21,32,1,3,29,44,56,21,-35,-15,-11,0,0,0,0
1213,2,0,H,2,1,667,1,1,44,35,2,5,36,37,49,58,9,-1,9,0,0,0,0
1213,0,0,D,2,0,668,0,0,30,34,2,2,35,48,40,29,-11,-13,-4,0,0,0,0
1213,1,0,H,1,3,669,1,3,33,47,3,9,37,34,36,33,-3,3,-14,0,0,0,1
1213,0,0,D,2,3,670,1,3,35,36,1,11,35,33,42,30,-12,2,-1,0,0,0,1
1213,2,1,H,0,2,671,0,2,35,51,2,8,53,35,48,35,-13,18,-16,0,0,0,0
1213,0,1,A,1,2,672,1,1,35,54,0,6,52,32,44,31,-13,20,-19,0,0,0,0
1213,2,2,D,2,2,673,1,0,26,31,1,8,29,40,45,29,-16,-11,-5,0,0,0,0
1213,1,2,A,3,4,674,2,3,47,65,0,13,57,18,37,44,7,39,-18,0,0,0,1
1213,2,1,H,3,2,675,3,1,47,45,0,8,39,36,35,37,2,3,2,0,0,1,0
1213,2,0,H,0,2,676,0,1,21,47,1,8,60,49,43,23,-20,11,-26,0,0,0,0
1213,3,0,H,1,1,677,1,0,35,21,2,4,21,58,39,36,-3,-37,14,0,0,0,0
1213,3,5,A,1,4,678,1,3,36,56,3,13,50,26,36,34,-2,24,-20,0,0,0,1
1213,0,0,D,1,1,679,0,1,41,35,2,4,39,38,38,38,0,1,6,0,0,0,0
1213,0,2,A,3,3,680,3,2,37,47,2,9,45,39,33,35,2,6,-10,0,0,1,0
1213,2,2,D,1,1,681,1,1,36,36,1,6,37,41,38,39,1,-4,0,0,0,0,0
1213,2,1,H,4,1,682,3,0,68,21,1,4,21,61,19,59,40,-40,47,0,0,1,0
1213,0,0,D,2,0,683,1,0,45,38,2,2,37,49,38,40,2,-12,7,0,0,0,0
1213,2,2,D,2,2,684,2,1,51,57,2,6,53,32,37,54,17,21,-6,0,0,0,0
1213,3,4,A,3,2,685,2,1,50,36,0,7,30,42,39,47,8,-12,14,0,0,0,0
1213,2,0,H,4,2,686,3,1,59,27,1,7,31,47,29,55,26,-16,32,0,0,1,0
1213,1,3,A,3,0,687,3,0,37,24,2,1,25,43,35,35,0,-18,13,0,0,1,0
1213,0,0,D,2,1,688,0,1,32,38,2,5,39,39,42,31,-11,0,-6,0,0,0,0
1213,3,1,H,1,1,689,0,1,42,35,2,3,31,45,38,38,0,-14,7,0,0,0,0
1213,1,1,D,2,3,690,1,3,47,50,2,9,39,36,51,60,9,3,-3,0,0,0,1
1213,0,2,A,2,2,691,1,2,39,52,1,8,56,39,45,34,-11,17,-13,0,0,0,0
1213,2,3,A,1,2,692,0,0,21,33,1,8,31,42,63,22,-41,-11,-12,0,0,0,0
1213,2,0,H,0,3,693,0,2,39,50,2,9,50,43,49,37,-12,7,-11,0,0,0,0
1213,0,0,D,1,2,694,1,1,35,46,0,8,40,38,48,32,-16,2,-11,0,0,0,0
1213,1,1,D,2,3,695,1,3,27,37,1,11,36,38,49,31,-18,-2,-10,0,0,0,1
1213,1,1,D,2,4,696,1,3,58,62,0,13,57,29,34,55,21,28,-4,0,0,0,1
1213,1,1,D,0,1,697,0,1,27,37,1,4,41,40,44,28,-16,1,-10,0,0,0,0
1213,0,3,A,1,1,698,1,0,39,45,2,5,41,39,39,39,0,2,-6,0,0,0,0
1213,1,2,A,1,2,699,1,1,37,48,3,8,61,52,43,39,-4,9,-11,0,0,0,0
1213,0,2,A,3,4,700,3,3,51,71,0,13,61,20,37,40,3,41,-20,0,0,1,1
1213,1,1,D,2,2,701,1,1,28,39,1,7,34,47,50,32,-18,-13,-11,0,0,0,0
1213,1,0,H,1,3,702,0,3,48,51,2,9,40,39,39,44,5,1,-3,0,0,0,1
1213,1,1,D,1,3,703,1,3,38,38,1,11,37,39,41,42,1,-2,0,0,0,0,1
1213,1,1,D,2,0,704,1,0,47,28,2,1,29,45,38,40,2,-16,19,0,0,0,0
1213,4,3,H,2,1,705,2,1,55,37,2,6,40,45,39,58,19,-5,18,0,0,0,0
1213,1,0,H,3,1,706,2,1,50,39,0,5,39,42,45,50,5,-3,11,0,0,0,0
1213,1,0,H,4,2,707,3,1,74,59,1,6,56,35,20,63,43,21,15,0,0,1,0
1213,3,2,H,4,0,708,3,0,63,42,1,2,39,49,30,58,28,-10,21,0,0,1,0
1213,1,1,D,2,1,709,1,0,51,21,2,4,24,66,53,63,10,-42,30,0,0,0,0
1213,0,1,A,2,1,710,0,1,36,36,2,3,32,48,44,34,-10,-16,0,0,0,0,0
1213,1,1,D,2,1,711,1,1,40,39,1,4,43,42,48,35,-13,1,1,0,0,0,0
1213,0,1,A,0,1,712,0,0,42,51,2,5,45,39,52,41,-11,6,-9,0,0,0,0
1213,0,3,A,1,4,713,0,3,22,66,1,13,61,32,67,25,-42,29,-44,0,0,0,1
1213,0,1,A,1,2,714,1,1,39,29,0,7,33,51,48,33,-15,-18,10,0,0,0,0
1213,4,2,H,2,2,715,1,1,59,48,0,8,41,39,36,56,20,2,11,0,0,0,0
1213,1,0,H,0,3,716,0,2,29,53,1,9,51,45,46,30,-16,6,-24,0,0,0,0
1213,0,0,D,1,3,717,1,3,39,51,2,9,40,40,43,39,-4,0,-12,0,0,0,1
1213,4,0,H,2,2,718,1,0,52,36,2,8,34,45,54,64,10,-11,16,0,0,0,0
1213,0,3,A,3,2,719,3,2,39,58,2,8,62,42,40,38,-2,20,-19,0,0,1,0
1213,0,2,A,1,4,720,1,3,37,77,3,13,64,20,49,43,-6,44,-40,0,0,0,1
1213,0,0,D,1,0,721,1,0,39,42,0,2,41,53,49,33,-16,-12,-3,0,0,0,0
1213,0,1,A,2,2,722,2,1,61,55,2,8,68,54,42,65,23,14,6,0,0,0,0
1213,3,0,H,2,2,723,1,0,48,36,2,8,34,49,43,43,0,-15,12,0,0,0,0
1213,4,1,H,2,1,724,1,0,32,22,1,4,25,70,51,34,-17,-45,10,0,0,0,0
1213,1,0,H,4,0,725,3,0,80,32,1,1,31,46,20,66,46,-15,48,0,0,1,0
1213,6,0,H,3,1,726,3,1,52,40,0,4,44,43,40,40,0,1,12,0,0,1,0
1213,1,0,H,2,1,727,1,1,62,37,0,6,43,51,38,60,22,-8,25,0,0,0,0
1213,3,1,H,4,3,728,3,2,69,53,1,9,51,46,32,64,32,5,16,0,0,1,0
1213,2,0,H,1,2,729,1,1,40,41,2,7,36,49,43,39,-4,-13,-1,0,0,0,0
1213,3,1,H,1,3,730,0,3,54,39,2,11,38,43,39,46,7,-5,15,0,0,0,1
1213,0,1,A,2,1,731,1,1,58,40,2,3,33,49,54,69,15,-16,18,0,0,0,0
1213,0,1,A,2,4,732,1,3,41,83,1,13,67,20,51,36,-15,47,-42,0,0,0,1
1213,0,3,A,1,4,733,1,3,40,72,1,13,67,33,49,44,-5,34,-32,0,0,0,1
1213,0,1,A,0,1,734,0,1,43,43,2,5,41,43,53,41,-12,-2,0,0,0,0,0
1213,1,3,A,3,3,735,2,3,53,55,0,9,46,40,49,52,3,6,-2,0,0,0,1
1213,2,3,A,0,1,736,0,0,32,57,1,5,49,40,47,31,-16,9,-25,0,0,0,0
1213,0,4,A,1,2,737,0,1,22,65,1,6,61,38,74,26,-48,23,-43,0,0,0,0
1213,1,1,D,3,2,738,3,1,39,51,2,8,46,43,46,39,-7,3,-12,0,0,1,0
1213,0,1,A,2,2,739,0,2,36,61,2,8,65,43,52,34,-18,22,-25,0,0,0,0
1213,0,0,D,1,2,740,1,1,37,35,3,7,38,52,52,43,-9,-14,2,0,0,0,0
1213,1,0,H,2,1,741,1,0,52,22,2,4,26,78,44,47,3,-52,30,0,0,0,0
1213,1,1,D,4,0,742,3,0,86,43,1,2,41,54,20,68,48,-13,43,0,0,1,0
1213,1,1,D,1,1,743,1,1,43,38,0,6,43,52,49,34,-15,-9,5,0,0,0,0
1213,1,0,H,2,0,744,2,0,64,32,2,1,33,50,43,66,23,-17,32,0,0,0,0
1213,0,0,D,2,3,745,1,2,36,53,1,9,53,52,52,38,-14,1,-17,0,0,0,0
1213,2,0,H,3,3,746,3,3,58,40,0,11,40,47,41,49,8,-7,18,0,0,1,1
1213,0,0,D,2,2,747,1,1,68,58,0,8,69,55,38,65,27,14,10,0,0,0,0
1213,2,1,H,4,2,748,3,0,75,36,1,8,34,53,33,70,37,-19,39,0,0,1,0
1213,0,2,A,1,1,749,1,1,46,40,2,4,44,52,43,42,-1,-8,6,0,0,0,0
1213,2,1,H,1,2,750,0,1,60,41,2,7,36,52,42,52,10,-16,19,0,0,0,0
1213,3,2,H,3,4,751,3,3,40,87,2,13,69,21,49,40,-9,48,-47,0,0,1,1
1213,2,2,D,2,1,752,1,1,41,44,1,3,35,50,54,37,-17,-15,-3,0,0,0,0
1213,0,0,D,1,2,753,1,1,43,37,1,7,38,52,52,46,-6,-14,6,0,0,0,0
1213,1,0,H,0,3,754,0,3,44,61,2,9,51,41,55,42,-13,10,-17,0,0,0,1
1213,2,5,A,3,1,755,2,0,54,63,0,5,54,43,52,53,1,11,-9,0,0,0,0
1213,1,3,A,0,1,756,0,1,32,46,1,5,42,45,51,33,-18,-3,-14,0,0,0,0
1213,1,5,A,1,2,757,0,2,22,67,1,8,67,43,79,26,-53,24,-45,0,0,0,0
1213,2,1,H,2,4,758,1,3,59,78,2,13,72,34,55,69,14,38,-19,0,0,0,1
1213,1,2,A,2,2,759,0,1,36,69,2,6,65,38,55,35,-20,27,-33,0,0,0,0
1213,2,2,D,1,2,760,1,1,39,55,3,8,48,44,53,44,-9,4,-16,0,0,0,0
1415,0,1,A,0,0,761,0,0,0,0,0,0,0,0,0,0,0,0,0,0,0,0,0
1415,2,0,H,0,0,762,0,0,0,0,0,0,0,0,0,0,0,0,0,0,0,0,0
1415,0,0,D,0,0,763,0,0,0,0,0,0,0,0,0,0,0,0,0,0,0,0,0
1415,1,0,H,0,0,764,0,0,0,0,0,0,0,0,0,0,0,0,0,0,0,0,0
1415,1,2,A,0,0,765,0,0,0,0,0,0,0,0,0,0,0,0,0,0,0,0,0
1415,3,1,H,0,0,766,0,0,0,0,0,0,0,0,0,0,0,0,0,0,0,0,0
1415,1,1,D,0,0,767,0,0,0,0,0,0,0,0,0,0,0,0,0,0,0,0,0
1415,1,1,D,0,0,768,0,0,0,0,0,0,0,0,0,0,0,0,0,0,0,0,0
1415,0,0,D,0,0,769,0,0,0,0,0,0,0,0,0,0,0,0,0,0,0,0,0
1415,2,0,H,0,0,770,0,0,0,0,0,0,0,0,0,0,0,0,0,0,0,0,0
1415,0,1,A,0,1,771,0,1,0,3,0,3,2,0,2,0,-2,2,-3,0,0,0,0
1415,2,0,H,1,1,772,1,1,3,3,0,3,2,0,0,1,1,2,0,0,0,0,0
1415,1,2,A,0,0,773,0,0,1,1,1,1,0,0,1,1,0,0,0,0,0,0,0
1415,0,0,D,0,0,774,0,0,0,0,0,0,1,2,2,0,-2,-1,0,0,0,0,0
1415,7,0,H,0,0,775,0,0,1,1,1,1,1,1,0,0,0,0,0,0,0,0,0
1415,3,0,H,0,1,776,0,1,0,3,0,3,1,0,3,1,-2,1,-3,0,0,0,0
1415,0,1,A,1,0,777,1,0,3,0,0,0,0,1,1,2,1,-1,3,0,0,0,0
1415,4,5,A,0,1,778,0,1,0,3,0,3,3,1,1,0,-1,2,-3,0,0,0,0
1415,2,0,H,0,0,779,0,0,1,1,1,1,0,0,1,1,0,0,0,0,0,0,0
1415,2,1,H,0,0,780,0,0,1,1,1,1,1,1,0,0,0,0,0,0,0,0,0
1415,2,2,D,1,0,781,1,0,3,0,0,0,0,3,3,1,-2,-3,3,0,0,0,0
1415,0,1,A,2,2,782,2,2,6,6,0,6,3,0,5,8,3,3,0,0,0,0,0
1415,0,1,A,1,0,783,1,0,4,1,1,1,0,2,1,2,1,-2,3,0,0,0,0
1415,2,3,A,1,0,784,1,0,3,0,0,0,4,6,1,1,0,-2,3,0,0,0,0
1415,1,0,H,0,1,785,0,1,1,3,1,3,4,3,2,1,-1,1,-2,0,0,0,0
1415,1,1,D,0,1,786,0,1,1,4,1,4,7,0,3,2,-1,7,-3,0,0,0,0
1415,2,0,H,2,0,787,2,0,6,1,0,1,2,3,0,3,3,-1,5,0,0,0,0
1415,0,0,D,0,1,788,0,1,1,4,1,4,3,1,8,1,-7,2,-3,0,0,0,0
1415,0,1,A,0,1,789,0,1,1,4,1,4,2,1,2,0,-2,1,-3,0,0,0,0
1415,1,0,H,1,1,790,1,1,3,3,0,3,2,2,2,2,0,0,0,0,0,0,0
1415,2,2,D,0,2,791,0,2,1,6,1,6,8,6,5,2,-3,2,-5,0,0,0,0
1415,1,2,A,0,0,792,0,0,1,1,1,1,0,3,5,2,-3,-3,0,0,0,0,0
1415,0,0,D,1,0,793,1,0,4,2,1,2,1,8,2,1,-1,-7,2,0,0,0,0
1415,2,0,H,1,1,794,1,1,5,4,2,4,2,2,1,8,7,0,1,0,0,0,0
1415,3,0,H,3,1,795,3,1,9,4,0,4,3,5,0,4,4,-2,5,0,0,1,0
1415,3,3,D,1,0,796,1,0,3,2,0,2,3,4,3,2,-1,-1,1,0,0,0,0
1415,1,2,A,1,3,797,1,3,3,9,0,9,5,0,8,7,-1,5,-6,0,0,0,1
1415,2,1,H,1,1,798,1,1,5,3,2,3,3,4,1,3,2,-1,2,0,0,0,0
1415,2,2,D,2,1,799,2,1,7,4,1,4,2,2,1,3,2,0,3,0,0,0,0
1415,0,1,A,1,2,800,1,2,3,6,0,6,3,2,4,4,0,1,-3,0,0,0,0
1415,0,3,A,1,4,801,1,3,4,12,1,12,7,0,4,2,-2,7,-8,0,0,0,1
1415,2,0,H,4,2,802,3,2,12,8,0,8,5,3,1,7,6,2,4,0,0,1,0
1415,1,1,D,1,2,803,1,2,4,7,1,7,10,8,8,3,-5,2,-3,0,0,0,0
1415,1,1,D,1,0,804,1,0,3,2,0,2,4,7,6,4,-2,-3,1,0,0,0,0
1415,0,1,A,1,2,805,1,1,5,8,2,8,5,2,4,4,0,3,-3,0,0,0,0
1415,1,4,A,2,0,806,1,0,8,1,2,1,3,7,1,10,9,-4,7,0,0,0,0
1415,0,1,A,0,1,807,0,1,3,4,3,4,5,6,8,1,-7,-1,-1,0,0,0,0
1415,1,1,D,1,1,808,0,1,4,5,1,5,1,2,4,2,-2,-1,-1,0,0,0,0
1415,0,4,A,0,1,809,0,1,3,3,3,3,4,5,7,6,-1,-1,0,0,0,0,0
1415,4,2,H,3,1,810,2,1,9,3,0,3,8,10,2,4,2,-2,6,0,0,0,0
1415,2,0,H,2,1,811,2,1,8,4,2,4,5,7,9,11,2,-2,4,0,0,0,0
1415,1,0,H,2,1,812,2,0,8,4,2,4,7,8,5,5,0,-1,4,0,0,0,0
1415,3,0,H,0,0,813,0,0,3,3,3,3,6,11,8,5,-3,-5,0,0,0,0,0
1415,3,0,H,1,2,814,1,1,6,8,3,8,11,5,3,2,-1,6,-2,0,0,0,0
1415,3,2,H,5,5,815,3,3,15,15,0,15,9,1,0,10,10,8,0,1,1,1,1
1415,3,2,H,2,0,816,1,0,6,3,0,3,1,9,5,8,3,-8,3,0,0,0,0
1415,2,1,H,2,1,817,1,0,7,5,1,5,3,5,6,6,0,-2,2,0,0,0,0
1415,1,2,A,1,1,818,1,1,3,5,0,5,4,5,14,10,-4,-1,-2,0,0,0,0
1415,1,0,H,3,1,819,1,1,11,4,2,4,2,7,2,6,4,-5,7,0,0,0,0
1415,1,1,D,4,1,820,2,1,12,5,0,5,4,9,4,8,4,-5,7,0,0,0,0
1415,3,0,H,5,1,821,3,1,15,4,0,4,5,9,4,11,7,-4,11,1,0,1,0
1415,1,1,D,0,5,822,0,3,3,18,3,15,13,2,12,3,-9,11,-15,0,1,0,1
1415,1,0,H,1,1,823,1,1,4,3,1,3,11,16,8,2,-6,-5,1,0,0,0,0
1415,2,2,D,1,3,824,0,1,4,14,1,11,7,2,9,7,-2,5,-10,0,0,0,0
1415,0,2,A,1,2,825,1,1,9,9,3,6,11,7,3,5,2,4,0,0,0,0,0
1415,2,2,D,2,2,826,1,1,8,10,2,7,8,7,8,11,3,1,-2,0,0,0,0
1415,2,1,H,0,1,827,0,1,3,6,3,5,5,10,14,6,-8,-5,-3,0,0,0,0
1415,1,0,H,1,4,828,0,2,5,13,2,12,9,5,7,4,-3,4,-8,0,0,0,0
1415,1,3,A,2,2,829,2,2,11,11,2,8,13,9,5,6,1,4,0,0,0,0,0
1415,1,1,D,1,0,830,1,0,8,6,2,3,8,8,6,6,0,0,2,0,0,0,0
1415,0,4,A,0,1,831,0,0,7,5,3,4,9,11,9,9,0,-2,2,0,0,0,0
1415,1,3,A,1,0,832,1,0,3,4,0,3,4,13,17,11,-6,-9,-1,0,0,0,0
1415,0,0,D,3,5,833,1,3,15,18,2,15,14,4,4,9,5,10,-3,0,1,0,1
1415,0,1,A,1,2,834,1,1,6,9,2,8,13,10,12,6,-6,3,-3,0,0,0,0
1415,1,2,A,1,1,835,1,1,4,9,1,5,7,7,12,5,-7,0,-5,0,0,0,0
1415,2,0,H,5,0,836,3,0,19,6,0,3,8,15,3,14,11,-7,13,1,0,1,0
1415,2,1,H,2,1,837,1,0,12,8,0,5,5,7,7,13,6,-2,4,0,0,0,0
1415,1,1,D,2,1,838,2,1,14,9,2,6,5,5,10,16,6,0,5,0,0,0,0
1415,6,2,H,2,2,839,1,2,11,11,1,8,7,8,9,10,1,-1,0,0,0,0,0
1415,2,0,H,4,1,840,2,1,13,7,0,4,3,8,6,9,3,-5,6,0,0,0,0
1415,3,1,H,0,0,841,0,0,7,7,3,3,9,13,14,7,-7,-4,0,0,0,0,0
1415,1,1,D,1,2,842,1,1,7,14,1,7,16,11,10,3,-7,5,-7,0,0,0,0
1415,1,1,D,1,2,843,0,2,8,15,1,8,17,11,11,13,2,6,-7,0,0,0,0
1415,3,0,H,1,4,844,1,2,10,16,3,12,11,6,6,6,0,5,-6,0,0,0,0
1415,1,0,H,1,5,845,1,3,12,22,2,15,16,3,8,9,1,13,-10,0,1,0,1
1415,1,0,H,2,3,846,1,1,12,16,2,11,9,4,10,14,4,5,-4,0,0,0,0
1415,1,0,H,0,1,847,0,1,6,4,3,4,6,14,17,8,-9,-8,2,0,0,0,0
1415,2,0,H,5,1,848,3,1,19,6,0,5,6,13,4,14,10,-7,13,1,0,1,0
1415,1,0,H,1,1,849,0,1,8,3,2,3,12,20,9,6,-3,-8,5,0,0,0,0
1415,1,1,D,2,2,850,2,1,11,15,2,6,15,8,14,9,-5,7,-4,0,0,0,0
1415,0,2,A,0,5,851,0,3,7,22,3,15,16,4,16,10,-6,12,-15,0,1,0,1
1415,2,0,H,2,5,852,1,3,15,22,1,15,16,4,12,17,5,12,-7,0,1,0,1
1415,2,0,H,1,2,853,1,1,3,15,0,8,15,10,21,12,-9,5,-12,0,0,0,0
1415,0,0,D,1,0,854,1,0,4,10,1,3,10,15,15,6,-9,-5,-6,0,0,0,0
1415,0,2,A,2,0,855,2,0,16,9,2,3,9,17,12,18,6,-8,7,0,0,0,0
1415,3,1,H,3,1,856,1,1,16,13,2,6,9,6,5,9,4,3,3,0,0,0,0
1415,0,0,D,1,1,857,0,1,11,8,2,4,4,11,9,7,-2,-7,3,0,0,0,0
1415,2,4,A,4,1,858,2,1,16,15,0,5,10,8,9,11,2,2,1,0,0,0,0
1415,1,1,D,1,2,859,1,2,6,12,2,8,10,15,15,6,-9,-5,-6,0,0,0,0
1415,4,2,H,2,1,860,1,0,16,9,0,4,14,12,9,16,7,2,7,0,0,0,0
1415,2,2,D,3,2,861,1,2,19,16,2,8,18,14,6,12,6,4,3,0,0,0,0
1415,0,0,D,0,1,862,0,1,11,9,3,4,4,11,15,10,-5,-7,2,0,0,0,0
1415,1,1,D,1,1,863,0,1,9,18,1,5,14,10,16,16,0,4,-9,0,0,0,0
1415,2,1,H,1,1,864,1,1,5,7,1,5,7,16,15,6,-9,-9,-2,0,0,0,0
1415,2,1,H,0,2,865,0,1,7,19,3,6,20,11,18,10,-8,9,-12,0,0,0,0
1415,0,1,A,1,2,866,1,1,13,18,3,7,19,12,9,10,1,7,-5,0,0,0,0
1415,2,2,D,2,2,867,1,2,15,13,2,8,11,16,12,15,3,-5,2,0,0,0,0
1415,7,0,H,5,1,868,3,1,25,6,0,3,14,21,4,18,14,-7,19,1,0,1,0
1415,1,1,D,0,4,869,0,2,12,16,3,12,13,13,17,11,-6,0,-4,0,0,0,0
1415,3,0,H,5,1,870,3,0,22,12,0,5,7,9,6,16,10,-2,10,1,0,1,0
1415,1,2,A,1,5,871,1,3,10,25,1,15,19,6,11,4,-7,13,-15,0,1,0,1
1415,0,3,A,2,5,872,1,3,19,28,0,15,25,4,13,21,8,21,-9,0,1,0,1
1415,1,1,D,1,3,873,1,1,7,20,2,11,14,8,18,8,-10,6,-13,0,0,0,0
1415,1,1,D,2,2,874,2,1,17,16,2,8,17,14,16,20,4,3,1,0,0,0,0
1415,3,3,D,2,1,875,1,0,21,10,1,4,17,17,12,20,8,0,11,0,0,0,0
1415,0,2,A,1,0,876,1,0,6,10,0,3,12,19,28,14,-14,-7,-4,0,0,0,0
1415,0,1,A,1,0,877,0,0,12,12,2,3,10,15,12,7,-5,-5,0,0,0,0,0
1415,1,1,D,4,1,878,2,1,17,8,0,4,8,16,14,14,0,-8,9,0,0,0,0
1415,1,2,A,2,1,879,2,1,14,13,2,6,10,10,18,13,-5,0,1,0,0,0,0
1415,1,1,D,1,0,880,1,0,19,13,2,3,12,18,11,15,4,-6,6,0,0,0,0
1415,0,0,D,1,2,881,1,1,9,19,1,6,21,16,17,9,-8,5,-10,0,0,0,0
1415,2,1,H,0,2,882,0,2,15,14,3,8,14,20,15,11,-4,-6,1,0,0,0,0
1415,0,4,A,1,1,883,0,1,11,16,1,6,12,11,20,20,0,1,-5,0,0,0,0
1415,0,3,A,1,1,884,1,1,8,20,2,5,16,12,19,9,-10,4,-12,0,0,0,0
1415,0,0,D,0,1,885,0,1,13,10,3,4,5,13,19,14,-5,-8,3,0,0,0,0
1415,2,1,H,5,1,886,3,0,31,12,0,5,7,13,4,28,24,-6,19,1,0,1,0
1415,2,0,H,2,4,887,2,2,18,18,2,12,15,15,17,21,4,0,0,0,0,0,0
1415,2,1,H,0,1,888,0,1,14,6,3,3,14,30,19,13,-6,-16,8,0,0,0,0
1415,4,2,H,5,2,889,3,1,28,17,0,8,18,15,7,21,14,3,11,1,0,1,0
1415,1,1,D,3,2,890,1,1,21,22,2,7,23,15,9,15,6,8,-1,0,0,0,0
1415,0,0,D,1,5,891,1,3,19,34,3,15,30,5,11,16,5,25,-15,0,1,0,1
1415,2,2,D,5,0,892,3,0,31,18,0,3,13,16,9,25,16,-3,13,1,0,1,0
1415,2,2,D,1,0,893,0,0,12,17,2,3,15,20,15,8,-7,-5,-5,0,0,0,0
1415,3,2,H,1,1,894,1,1,11,8,1,5,9,22,13,5,-8,-13,3,0,0,0,0
1415,1,0,H,1,2,895,1,2,23,21,2,8,23,17,12,19,7,6,2,0,0,0,0
1415,1,2,A,2,4,896,1,2,17,18,2,12,15,17,19,20,1,-2,-1,0,0,0,0
1415,2,2,D,2,0,897,1,0,23,14,1,3,14,19,16,24,8,-5,9,0,0,0,0
1415,1,2,A,1,2,898,1,1,6,20,0,6,21,16,32,15,-17,5,-14,0,0,0,0
1415,0,2,A,1,1,899,0,1,11,10,1,4,9,17,24,20,-4,-8,1,0,0,0,0
1415,1,3,A,2,3,900,2,1,14,22,2,11,16,10,22,15,-7,6,-8,0,0,0,0
1415,3,0,H,2,1,901,1,1,23,14,0,4,8,15,17,23,6,-7,9,0,0,0,0
1415,2,1,H,0,0,902,0,0,18,19,3,3,15,18,22,17,-5,-3,-1,0,0,0,0
1415,1,4,A,1,1,903,1,1,8,20,2,6,16,11,25,11,-14,5,-12,0,0,0,0
1415,0,1,A,1,5,904,1,3,26,32,2,15,27,11,12,20,8,16,-6,0,1,0,1
1415,1,1,D,5,3,905,3,1,35,25,0,11,19,11,5,30,25,8,10,1,0,1,0
1415,2,0,H,2,2,906,2,1,21,24,2,7,26,18,18,23,5,8,-3,0,0,0,0
1415,0,0,D,1,1,907,1,0,6,11,0,4,20,26,34,16,-18,-6,-5,0,0,0,0
1415,1,2,A,4,2,908,2,2,21,14,0,8,16,25,18,17,-1,-9,7,0,0,0,0
1415,0,2,A,1,2,909,1,1,13,17,1,8,21,21,17,11,-6,0,-4,0,0,0,0
1415,0,0,D,0,1,910,0,0,15,13,3,5,10,17,21,16,-5,-7,2,0,0,0,0
1415,1,3,A,1,5,911,0,3,12,36,1,15,31,6,26,20,-6,25,-24,0,1,0,1
1415,2,0,H,2,1,912,1,1,24,7,1,3,16,34,20,26,6,-18,17,0,0,0,0
1415,0,0,D,5,2,913,3,2,35,24,0,8,25,18,11,28,17,7,11,1,0,1,0
1415,1,1,D,0,1,914,0,1,19,8,3,5,12,29,20,16,-4,-17,11,0,0,0,0
1415,3,3,D,1,0,915,1,0,14,21,1,3,19,23,18,8,-10,-4,-7,0,0,0,0
1415,1,1,D,1,0,916,1,0,23,16,3,3,16,21,12,20,8,-5,7,0,0,0,0
1415,2,2,D,2,2,917,1,1,20,26,2,6,26,17,21,23,2,9,-6,0,0,0,0
1415,2,2,D,3,4,918,1,2,26,21,2,12,18,20,12,20,8,-2,5,0,0,0,0
1415,2,1,H,1,1,919,0,1,14,26,2,5,20,13,17,10,-7,7,-12,0,0,0,0
1415,0,1,A,2,1,920,2,1,17,13,2,4,11,19,26,18,-8,-8,4,0,0,0,0
1415,3,0,H,2,3,921,1,1,27,27,0,11,22,14,19,28,9,8,0,0,0,0,0
1415,1,4,A,1,2,922,1,1,9,27,2,7,28,20,30,13,-17,8,-18,0,0,0,0
1415,0,0,D,1,1,923,1,0,16,17,1,5,12,18,19,12,-7,-6,-1,0,0,0,0
1415,0,0,D,0,2,924,0,2,17,17,3,8,18,27,22,17,-5,-9,0,0,0,0,0
1415,2,2,D,1,1,925,1,1,26,15,2,4,11,21,15,21,6,-10,11,0,0,0,0
1415,1,1,D,5,2,926,3,1,39,21,0,8,25,23,7,34,27,2,18,1,0,1,0
1415,1,2,A,2,0,927,2,0,25,20,2,3,17,21,18,25,7,-4,5,0,0,0,0
1415,5,0,H,0,1,928,0,0,22,12,3,4,21,29,26,22,-4,-8,10,0,0,0,0
1415,1,0,H,1,1,929,1,1,7,24,0,6,21,13,36,16,-20,8,-17,0,0,0,0
1415,0,1,A,4,5,930,2,3,22,36,0,15,28,11,22,20,-2,17,-14,0,1,0,1
1415,1,1,D,0,4,931,0,2,23,22,3,12,20,23,22,19,-3,-3,1,0,0,0,0
1415,1,1,D,1,2,932,0,2,18,25,2,8,26,20,18,12,-6,6,-7,0,0,0,0
1415,1,1,D,1,1,933,1,1,16,17,1,4,12,19,23,13,-10,-7,-1,0,0,0,0
1415,2,1,H,1,1,934,0,1,12,9,1,5,14,34,34,21,-13,-20,3,0,0,0,0
1415,4,3,H,1,0,935,1,0,24,25,3,3,27,26,14,21,7,1,-1,0,0,0,0
1415,3,1,H,2,1,936,1,1,22,27,2,5,23,17,24,26,2,6,-5,0,0,0,0
1415,1,3,A,2,5,937,1,3,30,40,1,15,35,8,21,32,11,27,-10,0,1,0,1
1415,2,2,D,5,2,938,3,1,39,30,0,6,31,19,11,29,18,12,9,1,0,1,0
1415,1,0,H,3,0,939,1,0,27,18,2,3,17,22,17,22,5,-5,9,0,0,0,0
1415,3,1,H,2,1,940,2,1,18,10,2,3,17,36,27,18,-9,-19,8,0,0,0,0
1415,0,0,D,0,2,941,0,1,18,25,3,8,29,25,23,17,-6,4,-7,0,0,0,0
1415,1,1,D,0,5,942,0,3,25,40,3,15,31,13,30,30,0,18,-15,0,1,0,1
1415,2,3,A,1,1,943,1,0,9,19,2,5,13,19,36,15,-21,-6,-10,0,0,0,0
1415,1,2,A,1,1,944,1,1,18,27,1,6,25,17,20,13,-7,8,-9,0,0,0,0
1415,3,3,D,1,0,945,1,0,27,24,2,3,20,23,20,24,4,-3,3,0,0,0,0
1415,4,0,H,5,2,946,3,2,43,21,0,8,21,28,9,38,29,-7,22,1,0,1,0
1415,0,1,A,2,2,947,1,1,31,30,0,7,33,24,21,33,12,9,1,0,0,0,0
1415,0,1,A,2,1,948,2,1,26,17,2,4,14,24,21,27,6,-10,9,0,0,0,0
1415,0,2,A,1,3,949,1,1,10,30,0,11,23,17,39,18,-21,6,-20,0,0,0,0
1415,2,2,D,4,1,950,2,0,23,15,0,4,23,35,24,21,-3,-12,8,0,0,0,0
1415,2,1,H,1,0,951,0,0,16,25,1,3,23,26,37,25,-12,-3,-9,0,0,0,0
1415,3,1,H,2,2,952,1,2,31,26,3,8,27,22,22,33,11,5,5,0,0,0,0
1415,1,1,D,1,5,953,1,3,30,41,6,15,32,14,18,27,9,18,-11,0,1,0,1
1415,0,1,A,2,1,954,1,0,26,22,2,5,16,21,25,29,4,-5,4,0,0,0,0
1415,2,0,H,5,1,955,3,1,46,18,0,4,14,22,9,42,33,-8,28,1,0,1,0
1415,1,2,A,1,1,956,1,1,10,9,3,5,17,39,41,18,-23,-22,1,0,0,0,0
1415,1,1,D,3,0,957,1,0,33,26,2,3,31,31,17,25,8,0,7,0,0,0,0
1415,1,0,H,2,1,958,2,1,21,20,2,4,15,24,32,21,-11,-9,1,0,0,0,0
1415,1,2,A,0,4,959,0,2,19,24,6,12,23,26,23,17,-6,-3,-5,0,0,0,0
1415,2,1,H,2,1,960,1,1,33,28,1,5,27,23,24,34,10,4,5,0,0,0,0
1415,1,1,D,1,1,961,1,1,28,31,2,6,28,19,25,28,3,9,-3,0,0,0,0
1415,1,1,D,5,0,962,3,0,42,19,0,3,18,25,15,33,18,-7,23,1,0,1,0
1415,2,1,H,1,1,963,1,0,20,19,1,4,27,38,25,15,-10,-11,1,0,0,0,0
1415,2,1,H,1,2,964,1,1,12,34,5,6,36,23,40,19,-21,13,-22,0,0,0,0
1415,1,2,A,1,2,965,1,1,18,36,1,7,36,25,24,14,-10,11,-18,0,0,0,0
1415,3,1,H,2,1,966,2,1,26,10,2,3,19,43,25,28,3,-24,16,0,0,0,0
1415,2,1,H,0,2,967,0,2,27,24,6,8,22,32,32,32,0,-10,3,0,0,0,0
1415,3,1,H,0,2,968,0,1,25,26,6,8,29,26,28,24,-4,3,-1,0,0,0,0
1415,5,1,H,1,3,969,0,1,25,34,5,11,26,18,21,17,-4,8,-9,0,0,0,0
1415,0,0,D,4,5,970,2,3,27,49,3,15,44,9,27,25,-2,35,-22,0,1,0,1
1415,3,1,H,5,2,971,3,2,50,29,0,8,31,26,9,44,35,5,21,1,0,1,0
1415,1,3,A,2,1,972,2,0,24,28,2,5,22,22,34,23,-11,0,-4,0,0,0,0
1415,1,2,A,1,5,973,0,3,19,43,4,15,34,16,40,28,-12,18,-24,0,1,0,1
1415,2,0,H,0,1,974,0,1,20,15,3,5,21,41,26,19,-7,-20,5,0,0,0,0
1415,3,2,H,1,1,975,1,1,32,23,3,4,17,26,20,29,9,-9,9,0,0,0,0
1415,3,0,H,2,0,976,1,0,26,30,2,3,34,33,29,30,1,1,-4,0,0,0,0
1415,3,1,H,2,4,977,1,2,39,28,4,12,25,27,26,38,12,-2,11,0,0,0,0
1415,1,1,D,3,0,978,1,0,34,28,2,3,27,29,23,27,4,-2,6,0,0,0,0
1415,0,1,A,2,1,979,1,1,34,29,3,5,29,26,25,37,12,3,5,0,0,0,0
1415,0,1,A,1,1,980,1,1,10,18,0,4,15,26,46,20,-26,-11,-8,0,0,0,0
1415,3,1,H,0,2,981,0,1,30,42,3,7,41,27,36,34,-2,14,-12,0,0,0,0
1415,1,3,A,0,1,982,0,1,29,35,3,6,32,22,30,28,-2,10,-6,0,0,0,0
1415,1,4,A,1,2,983,1,1,23,29,4,8,33,29,29,19,-10,4,-6,0,0,0,0
1415,2,2,D,1,5,984,1,3,15,53,5,15,47,10,43,21,-22,37,-38,0,1,0,1
1415,2,1,H,1,3,985,1,1,21,35,4,11,28,24,26,16,-10,4,-14,0,0,0,0
1415,5,2,H,1,2,986,1,2,32,24,2,8,24,37,26,30,4,-13,8,0,0,0,0
1415,1,1,D,2,0,987,2,0,29,23,2,3,21,26,29,32,3,-5,6,0,0,0,0
1415,0,0,D,5,1,988,3,1,46,10,0,3,20,47,17,36,19,-27,36,1,0,1,0
1415,1,1,D,1,1,989,0,0,31,19,2,4,29,42,23,25,2,-13,12,0,0,0,0
1415,0,1,A,4,2,990,2,1,28,34,0,6,37,26,30,26,-4,11,-6,0,0,0,0
1415,2,1,H,5,1,991,3,1,54,23,0,4,20,33,12,49,37,-13,31,1,0,1,0
1415,3,0,H,0,1,992,0,1,24,24,3,4,18,27,27,22,-5,-9,0,0,0,0,0
1415,1,1,D,1,1,993,1,0,38,32,3,5,26,24,23,35,12,2,6,0,0,0,0
1415,2,1,H,2,0,994,1,0,37,33,0,3,37,37,26,38,12,0,4,0,0,0,0
1415,2,0,H,2,1,995,2,1,30,16,2,5,23,45,30,33,3,-22,14,0,0,0,0
1415,1,1,D,2,5,996,2,3,24,47,5,15,36,17,42,26,-16,19,-23,0,1,0,1
1415,1,2,A,1,2,997,0,1,20,32,1,8,37,30,43,30,-13,7,-12,0,0,0,0
1415,2,0,H,2,0,998,1,0,42,29,1,3,29,33,30,42,12,-4,13,0,0,0,0
1415,1,1,D,3,1,999,1,1,35,35,2,5,35,28,26,29,3,7,0,0,0,0,0
1415,0,0,D,1,2,1000,1,2,24,33,1,8,35,30,30,18,-12,5,-9,0,0,0,0
1415,1,2,A,1,3,1001,1,1,23,36,1,11,30,27,35,21,-14,3,-13,0,0,0,0
1415,1,2,A,1,2,1002,0,2,20,25,1,8,27,43,45,31,-14,-16,-5,0,0,0,0
1415,1,0,H,1,4,1003,1,2,16,28,2,12,26,31,47,23,-24,-5,-12,0,0,0,0
1415,0,1,A,2,1,1004,1,1,35,39,2,6,36,24,31,39,8,12,-4,0,0,0,0
1415,0,0,D,0,0,1005,0,0,33,27,3,3,25,27,39,38,-1,-2,6,0,0,0,0
1415,0,3,A,0,2,1006,0,1,29,40,3,6,40,27,35,29,-6,13,-11,0,0,0,0
1415,1,0,H,1,2,1007,0,1,33,45,2,7,44,30,25,27,2,14,-12,0,0,0,0
1415,1,1,D,5,5,1008,3,3,48,57,0,15,51,13,18,37,19,38,-9,1,1,1,1
1415,2,2,D,2,2,1009,2,2,34,28,2,8,29,44,30,35,5,-15,6,0,0,0,0
1415,2,0,H,3,1,1010,1,0,39,20,2,4,32,47,28,32,4,-15,19,0,0,0,0
1415,0,0,D,1,0,1011,1,0,19,34,2,3,38,39,47,24,-23,-1,-15,0,0,0,0
1415,0,0,D,1,5,1012,1,3,25,49,1,15,38,19,30,18,-12,19,-24,0,1,0,1
1415,1,1,D,0,1,1013,0,1,28,36,3,5,36,29,27,25,-2,7,-8,0,0,0,0
1415,2,2,D,2,2,1014,1,1,45,35,1,8,39,32,31,44,13,7,10,0,0,0,0
1415,0,0,D,1,1,1015,1,1,11,23,0,4,22,37,47,20,-27,-15,-12,0,0,0,0
1415,3,2,H,4,1,1016,2,0,28,36,0,5,28,25,32,26,-6,3,-8,0,0,0,0
1415,1,0,H,5,0,1017,3,0,58,29,0,3,29,38,14,52,38,-9,29,1,0,1,0
1415,4,0,H,2,1,1018,1,1,43,42,0,6,37,24,27,43,16,13,1,0,0,0,0
1415,1,1,D,1,0,1019,0,0,20,29,1,3,26,28,49,32,-17,-2,-9,0,0,0,0
1415,0,1,A,0,5,1020,0,3,35,61,3,15,53,14,39,38,-1,39,-26,0,1,0,1
1415,0,0,D,1,4,1021,1,2,24,31,1,12,29,34,37,22,-15,-5,-7,0,0,0,0
1415,0,2,A,1,1,1022,1,1,37,26,2,4,18,30,30,37,7,-12,11,0,0,0,0
1415,1,1,D,2,1,1023,1,1,36,20,2,5,24,47,34,41,7,-23,16,0,0,0,0
1415,4,1,H,0,1,1024,0,1,29,12,3,3,20,47,39,29,-10,-27,17,0,0,0,0
1415,2,0,H,2,2,1025,2,1,29,46,2,7,46,33,46,31,-15,13,-17,0,0,0,0
1415,2,1,H,1,2,1026,1,2,42,35,3,8,37,32,28,37,9,5,7,0,0,0,0
1415,0,2,A,5,3,1027,3,1,50,42,0,11,34,28,19,38,19,6,8,1,0,1,0
1415,0,2,A,1,2,1028,0,1,36,46,2,6,47,27,28,30,2,20,-10,0,0,0,0
1415,1,0,H,1,0,1029,1,0,29,35,1,3,38,40,30,20,-10,-2,-6,0,0,0,0
1415,3,1,H,2,1,1030,2,0,35,21,2,4,33,50,34,38,4,-17,14,0,0,0,0
1415,0,1,A,1,5,1031,1,3,21,50,2,15,38,21,48,25,-23,17,-29,0,1,0,1
1415,3,1,H,0,0,1032,0,0,30,32,3,3,33,40,29,27,-2,-7,-2,0,0,0,0
1415,1,0,H,5,1,1033,3,1,64,37,0,5,37,32,14,54,40,5,27,1,0,1,0
1415,2,0,H,2,2,1034,1,2,49,32,0,8,33,46,27,49,22,-13,17,0,0,0,0
1415,1,1,D,2,1,1035,1,1,46,25,1,4,22,37,35,46,11,-15,21,0,0,0,0
1415,0,2,A,1,1,1036,1,0,12,36,0,5,30,30,51,21,-30,0,-24,0,0,0,0
1415,1,0,H,3,2,1037,1,1,45,37,2,8,42,35,28,36,8,7,8,0,0,0,0
1415,2,2,D,4,1,1038,2,1,32,45,0,6,39,29,34,29,-5,10,-13,0,0,0,0
1415,1,2,A,1,1,1039,1,0,26,39,1,5,32,30,38,23,-15,2,-13,0,0,0,0
1415,1,3,A,1,2,1040,0,1,21,52,1,6,51,27,53,34,-19,24,-31,0,0,0,0
1415,2,0,H,1,3,1041,1,1,46,48,3,11,37,28,31,41,10,9,-2,0,0,0,0
1415,1,1,D,1,4,1042,1,2,37,33,2,12,31,36,33,37,4,-5,4,0,0,0,0
1415,1,1,D,2,1,1043,1,1,37,12,2,3,21,53,36,42,6,-32,25,0,0,0,0
1415,2,0,H,5,0,1044,3,0,67,33,0,3,30,30,14,55,41,0,34,1,0,1,0
1415,1,2,A,0,2,1045,0,2,35,38,3,8,41,35,41,38,-3,6,-3,0,0,0,0
1415,1,0,H,5,2,1046,3,1,53,47,0,7,47,36,21,39,18,11,6,1,0,1,0
1415,1,0,H,0,1,1047,0,1,32,32,3,4,21,30,43,34,-9,-9,0,0,0,0,0
1415,3,3,D,2,1,1048,2,1,32,21,2,5,25,49,48,33,-15,-24,11,0,0,0,0
1415,1,0,H,1,4,1049,1,2,13,34,3,12,32,37,54,22,-32,-5,-21,0,0,0,0
1415,2,0,H,1,1,1050,1,0,38,21,2,4,35,56,34,38,4,-21,17,0,0,0,0
1415,1,0,H,1,5,1051,1,3,16,70,0,15,57,14,54,23,-31,43,-54,0,1,0,1
1415,0,3,A,2,2,1052,2,1,33,38,2,8,43,37,51,36,-15,6,-5,0,0,0,0
1415,2,1,H,1,0,1053,1,0,26,35,1,3,35,43,40,24,-16,-8,-9,0,0,0,0
1415,0,1,A,1,1,1054,1,1,22,32,2,4,21,31,52,28,-24,-10,-10,0,0,0,0
1415,4,0,H,2,0,1055,1,0,55,33,0,3,30,32,28,54,26,-2,22,0,0,0,0
1415,1,1,D,2,3,1056,2,1,41,48,2,11,37,30,36,43,7,7,-7,0,0,0,0
1415,3,0,H,2,1,1057,1,1,47,49,1,6,43,31,37,47,10,12,-2,0,0,0,0
1415,1,1,D,1,5,1058,0,3,42,56,2,15,40,21,31,34,3,19,-14,0,1,0,1
1415,1,3,A,4,0,1059,2,0,34,35,0,3,39,43,38,32,-6,-4,-1,0,0,0,0
1415,2,0,H,1,1,1060,1,1,41,19,2,3,24,54,34,40,6,-30,22,0,0,0,0
1415,2,0,H,5,2,1061,3,1,70,58,0,6,58,28,15,57,42,30,12,1,0,1,0
1415,0,0,D,3,1,1062,1,1,49,22,2,5,28,53,31,38,7,-25,27,0,0,0,0
1415,0,3,A,1,2,1063,0,1,21,50,1,7,50,37,58,35,-23,13,-29,0,0,0,0
1415,1,1,D,1,4,1064,1,2,35,34,1,12,33,41,31,22,-9,-8,1,0,0,0,0
1415,2,2,D,0,1,1065,0,1,33,19,3,3,24,56,36,30,-6,-32,14,0,0,0,0
1415,0,0,D,2,2,1066,1,2,41,42,2,8,44,37,37,46,9,7,-1,0,0,0,0
1415,2,1,H,0,1,1067,0,1,38,44,3,5,42,34,44,42,-2,8,-6,0,0,0,0
1415,1,1,D,5,1,1068,3,1,57,29,0,4,26,41,22,41,19,-15,28,1,0,1,0
1415,1,1,D,0,1,1069,0,0,35,43,3,5,35,32,45,36,-9,3,-8,0,0,0,0
1415,0,1,A,1,2,1070,1,2,49,33,3,8,36,54,34,43,9,-18,16,0,0,0,0
1415,2,1,H,2,5,1071,1,3,42,58,2,15,42,23,37,46,9,19,-16,0,1,0,1
1415,2,1,H,4,2,1072,2,2,35,43,0,8,44,37,42,34,-8,7,-8,0,0,0,0
1415,2,2,D,1,0,1073,1,0,30,34,1,3,32,38,42,27,-15,-6,-4,0,0,0,0
1415,1,3,A,1,1,1074,1,0,49,21,3,4,35,61,35,43,8,-26,28,0,0,0,0
1415,3,1,H,1,1,1075,1,1,44,23,2,5,28,53,36,43,7,-25,21,0,0,0,0
1415,1,1,D,2,1,1076,1,1,58,36,0,4,23,32,30,58,28,-9,22,0,0,0,0
1415,4,2,H,2,3,1077,1,1,53,50,1,11,38,31,37,53,16,7,3,0,0,0,0
1415,1,0,H,1,0,1078,1,0,20,41,0,3,44,45,58,26,-32,-1,-21,0,0,0,0
1415,2,1,H,1,5,1079,0,3,44,73,2,15,59,15,33,36,3,44,-29,0,1,0,1
1415,3,2,H,2,0,1080,2,0,36,36,2,3,37,46,54,37,-17,-9,0,0,0,0,0
1415,1,2,A,4,2,1081,2,1,38,45,0,8,48,38,43,36,-7,10,-7,0,0,0,0
1415,2,2,D,1,1,1082,1,1,23,31,2,4,29,44,56,29,-27,-15,-8,0,0,0,0
1415,1,0,H,1,1,1083,1,0,37,24,1,4,38,62,33,24,-9,-24,13,0,0,0,0
1415,3,2,H,5,1,1084,3,1,73,49,0,6,44,38,17,60,43,6,24,1,0,1,0
1415,4,0,H,2,1,1085,1,1,59,23,0,3,27,58,31,59,28,-31,36,0,0,0,0
1415,1,3,A,2,1,1086,2,1,43,47,2,5,46,37,39,45,6,9,-4,0,0,0,0
1415,2,2,D,0,1,1087,0,0,41,47,3,5,38,34,46,44,-2,4,-6,0,0,0,0
1415,1,1,D,3,2,1088,1,2,50,39,2,8,40,56,35,40,5,-16,11,0,0,0,0
1415,0,3,A,0,5,1089,0,3,36,58,3,15,43,25,49,39,-10,18,-22,0,1,0,1
1415,4,2,H,0,2,1090,0,1,35,56,3,7,57,39,40,34,-6,18,-21,0,0,0,0
1415,0,1,A,3,5,1091,1,3,51,76,2,15,63,19,36,41,5,44,-25,0,1,0,1
1415,0,0,D,0,0,1092,0,0,36,42,3,3,46,48,52,39,-13,-2,-6,0,0,0,0
1415,1,1,D,1,2,1093,1,1,32,62,1,6,63,31,46,31,-15,32,-30,0,0,0,0
1415,3,1,H,1,1,1094,1,1,49,24,3,5,31,58,41,46,5,-27,25,0,0,0,0
1415,0,0,D,2,1,1095,1,1,48,40,2,4,25,33,39,50,11,-8,8,0,0,0,0
1415,3,0,H,2,2,1096,1,2,56,43,1,8,46,42,43,59,16,4,13,0,0,0,0
1415,2,0,H,5,1,1097,3,1,61,50,0,5,49,38,25,46,21,11,11,1,0,1,0
1415,0,1,A,2,4,1098,2,2,40,38,2,12,37,45,57,41,-16,-8,2,0,0,0,0
1415,4,0,H,1,1,1099,0,1,24,23,1,3,27,62,63,38,-25,-35,1,0,0,0,0
1415,0,1,A,1,0,1100,0,0,48,38,2,3,38,42,36,40,4,-4,10,0,0,0,0
1415,1,1,D,5,1,1101,3,0,79,27,0,4,42,63,19,64,45,-21,52,1,0,1,0
1415,2,1,H,2,5,1102,2,3,43,64,2,15,48,25,45,46,1,23,-21,0,1,0,1
1415,2,3,A,1,0,1103,1,0,24,37,2,3,39,52,61,32,-29,-13,-13,0,0,0,0
1415,2,2,D,1,2,1104,1,2,41,40,1,8,41,58,33,25,-8,-17,1,0,0,0,0
1415,2,3,A,0,1,1105,0,1,41,52,3,6,49,42,42,39,-3,7,-11,0,0,0,0
1415,1,2,A,2,2,1106,1,1,63,49,0,8,50,39,32,64,32,11,14,0,0,0,0
1415,2,3,A,0,1,1107,0,1,43,33,3,4,32,47,48,46,-2,-15,10,0,0,0,0
1415,2,2,D,1,2,1108,1,1,23,59,0,7,62,43,66,27,-39,19,-36,0,0,0,0
1415,1,4,A,4,3,1109,2,1,41,51,0,11,41,37,45,38,-7,4,-10,0,0,0,0
1415,5,1,H,1,1,1110,1,0,50,48,2,5,40,37,40,49,9,3,2,0,0,0,0
1415,1,2,A,2,5,1111,1,3,52,80,2,15,65,20,40,52,12,45,-28,0,1,0,1
1415,0,1,A,3,2,1112,1,1,54,63,2,6,65,34,38,45,7,31,-9,0,0,0,0
1415,1,4,A,1,1,1113,1,1,36,53,1,5,54,41,49,35,-14,13,-17,0,0,0,0
1415,0,1,A,1,0,1114,0,0,28,43,1,3,48,51,64,43,-21,-3,-15,0,0,0,0
1415,2,1,H,5,4,1115,3,2,64,41,0,12,39,49,27,49,22,-10,23,1,0,1,0
1415,3,2,H,0,2,1116,0,2,40,46,3,8,48,46,54,42,-12,2,-6,0,0,0,0
1415,2,0,H,1,1,1117,0,1,48,42,2,4,27,35,42,41,-1,-8,6,0,0,0,0
1415,2,1,H,2,0,1118,2,0,41,41,2,3,41,45,60,43,-17,-4,0,0,0,0,0
1415,3,0,H,1,1,1119,1,1,55,24,3,3,29,68,44,52,8,-39,31,0,0,0,0
1415,3,2,H,2,1,1120,1,1,60,24,1,5,34,64,45,64,19,-30,36,0,0,0,0
1415,3,2,H,1,2,1121,1,1,56,52,2,8,53,42,42,58,16,11,4,0,0,0,0
1415,3,1,H,5,2,1122,3,1,83,63,0,7,67,47,21,67,46,20,20,1,0,1,0
1415,0,1,A,1,1,1123,1,0,24,28,2,4,43,65,67,36,-31,-22,-4,0,0,0,0
1415,1,1,D,1,1,1124,1,1,42,36,1,4,36,53,37,27,-10,-17,6,0,0,0,0
1415,1,1,D,0,3,1125,0,1,41,54,3,11,45,39,47,42,-5,6,-13,0,0,0,0
1415,3,0,H,2,1,1126,2,0,46,51,2,5,43,42,49,50,1,1,-5,0,0,0,0
1415,2,3,A,0,1,1127,0,1,46,58,3,6,55,44,51,49,-2,11,-12,0,0,0,0
1415,2,2,D,1,2,1128,1,2,24,44,0,8,45,61,71,29,-42,-16,-20,0,0,0,0
1415,0,1,A,4,0,1129,2,0,41,43,0,3,45,56,51,40,-11,-11,-2,0,0,0,0
1415,1,2,A,2,5,1130,1,3,66,67,0,15,51,28,34,66,32,23,-1,0,1,0,1
1415,1,3,A,1,2,1131,1,2,37,49,1,8,53,49,54,37,-17,4,-12,0,0,0,0
1415,2,2,D,2,5,1132,2,3,45,86,2,15,70,22,63,47,-16,48,-41,0,1,0,1
1415,4,3,H,1,4,1133,0,2,31,41,1,12,40,52,65,44,-21,-12,-10,0,0,0,0
1415,3,0,H,1,1,1134,1,1,61,43,3,4,28,38,46,58,12,-10,18,0,0,0,0
1415,4,3,H,2,0,1135,1,0,52,42,2,3,43,48,45,55,10,-5,10,0,0,0,0
1415,2,4,A,2,2,1136,1,1,63,66,1,6,67,36,50,68,18,31,-3,0,0,0,0
1415,1,2,A,5,0,1137,3,0,70,46,0,3,51,54,29,53,24,-3,24,1,0,1,0
1415,2,2,D,3,1,1138,1,1,55,25,2,3,31,73,40,46,6,-42,30,0,0,0,0
1415,3,1,H,0,1,1139,0,1,46,59,3,5,61,44,56,46,-10,17,-13,0,0,0,0
1415,5,0,H,1,1,1140,0,1,51,24,2,5,36,68,45,43,-2,-32,27,0,0,0,0
1516,2,1,H,0,0,1141,0,0,0,0,0,0,0,0,0,0,0,0,0,0,0,0,0
1516,1,1,D,0,0,1142,0,0,0,0,0,0,0,0,0,0,0,0,0,0,0,0,0
1516,1,3,A,0,0,1143,0,0,0,0,0,0,0,0,0,0,0,0,0,0,0,0,0
1516,2,0,H,0,0,1144,0,0,0,0,0,0,0,0,0,0,0,0,0,0,0,0,0
1516,1,2,A,0,0,1145,0,0,0,0,0,0,0,0,0,0,0,0,0,0,0,0,0
1516,1,0,H,0,0,1146,0,0,0,0,0,0,0,0,0,0,0,0,0,0,0,0,0
1516,0,1,A,0,0,1147,0,0,0,0,0,0,0,0,0,0,0,0,0,0,0,0,0
1516,1,0,H,0,0,1148,0,0,0,0,0,0,0,0,0,0,0,0,0,0,0,0,0
1516,5,2,H,0,0,1149,0,0,0,0,0,0,0,0,0,0,0,0,0,0,0,0,0
1516,2,1,H,0,0,1150,0,0,0,0,0,0,0,0,0,0,0,0,0,0,0,0,0
1516,0,1,A,0,1,1151,0,1,0,3,0,3,2,1,2,1,-1,1,-3,0,0,0,0
1516,2,1,H,0,0,1152,0,0,0,0,0,0,1,3,2,0,-2,-2,0,0,0,0,0
1516,2,0,H,0,0,1153,0,0,0,0,0,0,1,2,1,0,-1,-1,0,0,0,0,0
1516,1,2,A,0,1,1154,0,1,0,3,0,3,1,0,5,2,-3,1,-3,0,0,0,0
1516,4,0,H,1,1,1155,1,1,3,3,0,3,2,1,1,3,2,1,0,0,0,0,0
1516,2,0,H,0,0,1156,0,0,0,1,0,1,1,1,1,0,-1,0,-1,0,0,0,0
1516,2,2,D,0,1,1157,0,1,0,3,0,3,5,2,2,1,-1,3,-3,0,0,0,0
1516,2,1,H,0,0,1158,0,0,1,0,1,0,0,1,1,1,0,-1,1,0,0,0,0
1516,3,1,H,1,1,1159,1,1,3,3,0,3,2,0,1,2,1,2,0,0,0,0,0
1516,0,1,A,1,1,1160,1,1,3,3,0,3,1,0,0,1,1,1,0,0,0,0,0
1516,1,0,H,1,1,1161,1,1,3,3,0,3,2,1,3,3,0,1,0,0,0,0,0
1516,0,2,A,0,1,1162,0,1,0,4,0,4,3,2,4,1,-3,1,-4,0,0,0,0
1516,1,1,D,0,2,1163,0,2,0,6,0,6,7,1,3,1,-2,6,-6,0,0,0,0
1516,2,2,D,0,0,1164,0,0,0,1,0,1,3,4,5,2,-3,-1,-1,0,0,0,0
1516,1,0,H,2,1,1165,2,1,6,3,0,3,2,3,1,3,2,-1,3,0,0,0,0
1516,2,0,H,1,1,1166,1,1,3,3,0,3,1,1,5,2,-3,0,0,0,0,0,0
1516,2,2,D,2,0,1167,2,0,6,0,0,0,3,7,0,2,2,-4,6,0,0,0,0
1516,2,2,D,2,1,1168,2,1,6,3,0,3,2,1,1,3,2,1,3,0,0,0,0
1516,2,2,D,0,2,1169,0,2,1,6,1,6,5,2,3,1,-2,3,-5,0,0,0,0
1516,2,0,H,1,0,1170,1,0,4,0,1,0,1,3,4,7,3,-2,4,0,0,0,0
1516,3,2,H,1,2,1171,1,2,3,7,0,7,4,2,4,2,-2,2,-4,0,0,0,0
1516,1,2,A,1,0,1172,1,0,3,1,0,1,4,7,3,1,-2,-3,2,0,0,0,0
1516,1,1,D,1,0,1173,1,0,4,2,1,2,3,5,3,4,1,-2,2,0,0,0,0
1516,1,0,H,0,0,1174,0,0,0,0,0,0,1,6,5,1,-4,-5,0,0,0,0,0
1516,0,1,A,0,2,1175,0,2,1,6,1,6,4,3,9,5,-4,1,-5,0,0,0,0
1516,0,1,A,2,3,1176,2,3,7,9,1,9,4,1,2,8,6,3,-2,0,0,0,1
1516,0,2,A,1,0,1177,1,0,3,1,0,1,2,4,2,2,0,-2,2,0,0,0,0
1516,5,0,H,0,2,1178,0,2,2,6,2,6,4,5,6,5,-1,-1,-4,0,0,0,0
1516,2,2,D,2,2,1179,2,2,7,7,1,7,5,3,2,5,3,2,0,0,0,0,0
1516,2,0,H,2,2,1180,2,2,7,7,1,7,9,4,4,7,3,5,0,0,0,0,0
1516,2,3,A,1,2,1181,1,1,3,6,0,6,5,6,5,2,-3,-1,-3,0,0,0,0
1516,0,0,D,0,1,1182,0,0,1,5,1,5,10,6,10,5,-5,4,-4,0,0,0,0
1516,1,0,H,2,3,1183,2,2,7,10,1,10,9,4,3,8,5,5,-3,0,0,0,0
1516,2,0,H,3,1,1184,2,0,9,3,0,3,2,5,3,5,2,-3,6,0,0,0,0
1516,1,0,H,4,0,1185,3,0,12,3,0,3,4,6,1,5,4,-2,9,0,0,1,0
1516,1,1,D,1,0,1186,0,0,4,0,1,0,1,7,4,4,0,-6,4,0,0,0,0
1516,2,0,H,2,1,1187,2,1,6,3,0,3,2,4,10,4,-6,-2,3,0,0,0,0
1516,0,1,A,2,2,1188,2,2,7,8,1,8,7,5,5,6,1,2,-1,0,0,0,0
1516,2,1,H,2,2,1189,2,2,7,8,1,8,7,4,6,9,3,3,-1,0,0,0,0
1516,0,1,A,1,1,1190,0,1,4,5,1,5,5,4,8,6,-2,1,-1,0,0,0,0
1516,2,1,H,1,1,1191,0,0,6,5,3,5,5,5,6,10,4,0,1,0,0,0,0
1516,5,1,H,2,0,1192,2,0,8,2,2,2,5,10,6,8,2,-5,6,0,0,0,0
1516,1,2,A,1,1,1193,0,1,3,3,0,3,4,8,7,2,-5,-4,0,0,0,0,0
1516,1,0,H,1,3,1194,1,1,3,9,0,9,8,8,6,2,-4,0,-6,0,0,0,0
1516,1,4,A,5,4,1195,3,2,15,12,0,12,7,3,1,6,5,4,3,1,0,1,0
1516,1,1,D,3,3,1196,2,2,11,10,2,10,9,3,5,8,3,6,1,0,0,0,0
1516,2,1,H,3,2,1197,2,2,10,7,1,7,6,6,5,9,4,0,3,0,0,0,0
1516,1,2,A,0,3,1198,0,2,3,9,3,9,6,10,7,4,-3,-4,-6,0,0,0,0
1516,2,1,H,2,3,1199,1,2,8,10,2,10,11,7,4,6,2,4,-2,0,0,0,0
1516,2,0,H,0,1,1200,0,0,1,4,1,4,6,9,8,2,-6,-3,-3,0,0,0,0
1516,2,1,H,0,3,1201,0,2,2,13,2,10,11,6,15,6,-9,5,-11,0,0,0,0
1516,1,1,D,3,0,1202,2,0,11,3,1,3,5,9,4,10,6,-4,8,0,0,0,0
1516,1,0,H,1,3,1203,0,2,4,12,1,11,9,6,11,6,-5,3,-8,0,0,0,0
1516,3,0,H,4,2,1204,2,1,15,11,0,8,8,5,4,11,7,3,4,0,0,0,0
1516,3,1,H,1,1,1205,0,0,5,3,2,3,3,9,7,6,-1,-6,2,0,0,0,0
1516,2,0,H,3,0,1206,2,0,12,4,0,1,4,8,11,8,-3,-4,8,0,0,0,0
1516,0,4,A,3,1,1207,1,0,9,9,0,6,12,7,9,8,-1,5,0,0,0,0,0
1516,2,4,A,2,2,1208,2,2,7,11,1,8,13,7,8,7,-1,6,-4,0,0,0,0
1516,1,1,D,3,5,1209,2,3,10,15,1,15,7,5,9,12,3,2,-5,0,1,0,1
1516,1,1,D,1,1,1210,1,1,6,6,0,3,3,6,9,6,-3,-3,0,0,0,0,0
1516,3,1,H,2,1,1211,2,0,14,7,2,4,7,11,9,17,8,-4,7,0,0,0,0
1516,1,1,D,3,3,1212,2,1,13,9,1,9,8,13,8,12,4,-5,4,0,0,0,0
1516,3,0,H,2,0,1213,1,0,11,5,2,2,8,16,8,8,0,-8,6,0,0,0,0
1516,0,1,A,1,2,1214,0,2,3,7,0,7,9,12,12,4,-8,-3,-4,0,0,0,0
1516,2,0,H,0,3,1215,0,2,4,11,1,10,13,10,10,4,-6,3,-7,0,0,0,0
1516,3,2,H,1,3,1216,1,2,7,12,0,10,11,5,7,4,-3,6,-5,0,0,0,0
1516,0,0,D,5,1,1217,3,0,16,8,0,5,9,8,6,8,2,1,8,1,0,1,0
1516,2,1,H,1,4,1218,0,2,12,18,3,12,14,4,7,16,9,10,-6,0,0,0,0
1516,2,1,H,3,3,1219,2,2,12,15,2,9,10,11,7,9,2,-1,-3,0,0,0,0
1516,1,1,D,0,1,1220,0,1,4,7,3,3,7,10,10,6,-4,-3,-3,0,0,0,0
1516,1,2,A,0,1,1221,0,0,5,3,2,3,4,13,19,8,-11,-9,2,0,0,0,0
1516,2,0,H,1,1,1222,0,1,7,10,1,3,7,9,14,8,-6,-2,-3,0,0,0,0
1516,1,1,D,2,5,1223,2,3,10,17,1,15,8,6,12,10,-2,2,-7,0,1,0,1
1516,0,1,A,3,1,1224,2,0,12,15,1,6,18,8,8,13,5,10,-3,0,0,0,0
1516,1,2,A,4,2,1225,2,2,18,17,0,8,20,10,6,15,9,10,1,0,0,0,0
1516,2,0,H,1,2,1226,0,1,9,14,2,8,11,8,8,9,1,3,-5,0,0,0,0
1516,3,0,H,3,3,1227,2,2,15,14,0,10,13,9,13,11,-2,4,1,0,0,0,0
1516,2,1,H,3,3,1228,1,2,10,15,0,11,11,8,14,9,-5,3,-5,0,0,0,0
1516,4,1,H,3,0,1229,2,0,11,5,1,3,7,11,12,13,1,-4,6,0,0,0,0
1516,1,0,H,1,0,1230,1,0,8,7,0,1,6,10,11,8,-3,-4,1,0,0,0,0
1516,0,1,A,1,5,1231,0,3,6,18,0,15,9,7,14,6,-8,2,-12,0,1,0,1
1516,2,1,H,2,3,1232,1,2,14,18,2,9,14,13,10,11,1,1,-4,0,0,0,0
1516,2,1,H,0,0,1233,0,0,7,5,1,2,9,21,11,6,-5,-12,2,0,0,0,0
1516,1,0,H,3,3,1234,1,2,13,12,0,10,13,9,15,11,-4,4,1,0,0,0,0
1516,2,0,H,1,2,1235,0,2,18,11,3,7,11,13,8,19,11,-2,7,0,0,0,0
1516,3,1,H,2,1,1236,2,1,20,11,2,3,9,11,11,22,11,-2,9,0,0,0,0
1516,1,0,H,3,1,1237,2,0,15,12,2,5,11,8,10,12,2,3,3,0,0,0,0
1516,3,3,D,3,1,1238,2,1,14,10,1,3,7,11,12,13,1,-4,4,0,0,0,0
1516,0,2,A,0,4,1239,0,2,5,18,3,12,16,8,15,8,-7,8,-13,0,0,0,0
1516,1,1,D,3,1,1240,2,0,14,10,1,4,10,14,13,17,4,-4,4,0,0,0,0
1516,1,0,H,5,2,1241,3,2,21,23,0,8,25,12,7,10,3,13,-2,1,0,1,0
1516,2,1,H,1,3,1242,0,2,12,15,2,10,16,15,9,11,2,1,-3,0,0,0,0
1516,3,0,H,1,2,1243,0,1,6,17,0,8,13,11,15,6,-9,2,-11,0,0,0,0
1516,0,0,D,0,0,1244,0,0,5,5,2,3,8,17,23,10,-13,-9,0,0,0,0,0
1516,4,1,H,4,0,1245,2,0,21,10,0,1,8,12,8,18,10,-4,11,0,0,0,0
1516,0,0,D,1,1,1246,1,0,11,21,0,6,21,8,14,10,-4,13,-10,0,0,0,0
1516,1,3,A,3,3,1247,2,1,18,16,0,9,12,15,15,15,0,-3,2,0,0,0,0
1516,0,0,D,1,3,1248,1,2,11,18,0,11,13,10,14,10,-4,3,-7,0,0,0,0
1516,1,1,D,3,3,1249,2,2,12,15,1,10,18,14,10,13,3,4,-3,0,0,0,0
1516,0,1,A,2,1,1250,2,0,11,11,1,4,11,15,15,11,-4,-4,0,0,0,0,0
1516,0,0,D,3,2,1251,1,1,19,17,0,8,13,14,16,15,-1,-1,2,0,0,0,0
1516,0,2,A,0,1,1252,0,0,6,9,3,3,9,15,17,8,-9,-6,-3,0,0,0,0
1516,1,3,A,1,1,1253,0,0,14,15,1,5,13,10,15,12,-3,3,-1,0,0,0,0
1516,2,2,D,0,1,1254,0,1,10,12,1,3,10,14,16,9,-7,-4,-2,0,0,0,0
1516,1,0,H,1,1,1255,0,1,22,12,3,3,10,14,8,21,13,-4,10,0,0,0,0
1516,1,0,H,2,3,1256,2,2,11,13,1,10,14,11,16,11,-5,3,-2,0,0,0,0
1516,2,0,H,2,3,1257,2,2,23,18,2,9,16,18,13,25,12,-2,5,0,0,0,0
1516,0,2,A,3,4,1258,2,2,16,24,1,12,22,9,15,19,4,13,-8,0,0,0,0
1516,1,0,H,3,0,1259,2,0,19,6,2,2,10,23,10,13,3,-13,13,0,0,0,0
1516,0,1,A,3,5,1260,2,3,15,24,1,15,11,7,17,17,0,4,-9,0,1,0,1
1516,2,2,D,1,2,1261,0,2,12,26,0,8,27,13,15,11,-4,14,-14,0,0,0,0
1516,1,0,H,1,3,1262,0,1,18,20,2,9,15,16,11,16,5,-1,-2,0,0,0,0
1516,0,1,A,2,3,1263,1,2,18,15,2,10,17,18,14,13,-1,-1,3,0,0,0,0
1516,1,2,A,0,3,1264,0,2,6,13,2,10,14,12,24,10,-14,2,-7,0,0,0,0
1516,2,2,D,4,1,1265,2,0,27,14,0,4,13,18,9,24,15,-5,13,0,0,0,0
1516,2,1,H,1,3,1266,1,2,13,22,0,11,14,10,16,12,-4,4,-9,0,0,0,0
1516,4,0,H,5,0,1267,3,0,27,11,0,1,11,18,7,12,5,-7,16,1,0,1,0
1516,1,1,D,3,2,1268,2,2,18,14,0,7,12,16,20,16,-4,-4,4,0,0,0,0
1516,1,0,H,1,3,1269,1,2,12,16,0,10,19,17,15,10,-5,2,-4,0,0,0,0
1516,0,2,A,0,1,1270,0,0,6,25,3,6,22,8,19,8,-11,14,-19,0,0,0,0
1516,4,1,H,3,3,1271,1,2,20,16,0,10,19,18,17,15,-2,1,4,0,0,0,0
1516,2,0,H,3,1,1272,2,0,18,13,1,3,13,17,18,18,0,-4,5,0,0,0,0
1516,2,3,A,3,1,1273,2,1,16,15,1,3,11,15,13,16,3,-4,1,0,0,0,0
1516,1,0,H,1,3,1274,0,2,15,19,1,9,17,21,20,15,-5,-4,-4,0,0,0,0
1516,3,2,H,0,0,1275,0,0,11,6,1,3,8,21,22,11,-11,-13,5,0,0,0,0
1516,1,2,A,1,0,1276,1,0,16,6,0,2,11,26,17,14,-3,-15,10,0,0,0,0
1516,0,3,A,2,1,1277,2,0,15,21,1,5,17,11,17,13,-4,6,-6,0,0,0,0
1516,0,2,A,2,2,1278,2,1,27,18,2,8,13,15,15,29,14,-2,9,0,0,0,0
1516,2,1,H,1,5,1279,0,3,28,30,3,15,16,7,8,24,16,9,-2,0,1,0,1
1516,1,1,D,3,4,1280,2,2,22,28,2,12,26,11,12,15,3,15,-6,0,0,0,0
1516,0,2,A,3,1,1281,2,0,19,24,0,5,20,11,22,17,-5,9,-5,0,0,0,0
1516,1,0,H,5,1,1282,3,1,30,16,0,3,15,19,9,17,8,-4,14,1,0,1,0
1516,1,1,D,3,2,1283,2,2,21,27,1,8,29,17,18,20,2,12,-6,0,0,0,0
1516,3,0,H,2,2,1284,1,2,21,15,2,7,13,20,15,15,0,-7,6,0,0,0,0
1516,3,2,H,1,1,1285,0,0,13,31,0,6,26,9,19,13,-6,17,-18,0,0,0,0
1516,0,0,D,0,3,1286,0,1,9,23,2,9,19,18,27,13,-14,1,-14,0,0,0,0
1516,3,0,H,4,1,1287,2,1,29,18,0,3,14,17,12,27,15,-3,11,0,0,0,0
1516,0,2,A,0,3,1288,0,2,14,16,1,10,18,16,24,14,-10,2,-2,0,0,0,0
1516,1,3,A,3,3,1289,2,2,16,23,1,11,16,13,22,20,-2,3,-7,0,0,0,0
1516,0,1,A,0,1,1290,0,0,6,18,3,4,16,20,24,10,-14,-4,-12,0,0,0,0
1516,0,1,A,1,1,1291,1,0,16,16,0,3,16,21,20,15,-5,-5,0,0,0,0,0
1516,4,1,H,2,0,1292,2,0,15,14,1,1,14,26,23,13,-10,-12,1,0,0,0,0
1516,0,4,A,1,5,1293,1,3,18,33,0,15,18,9,20,14,-6,9,-15,0,1,0,1
1516,1,0,H,3,2,1294,2,1,19,24,1,8,18,15,16,20,4,3,-5,0,0,0,0
1516,3,0,H,1,0,1295,0,0,21,10,1,2,13,27,20,17,-3,-14,11,0,0,0,0
1516,3,1,H,1,4,1296,0,2,27,32,2,12,30,12,11,22,11,18,-5,0,0,0,0
1516,1,1,D,3,0,1297,1,0,24,6,0,3,10,25,18,19,1,-15,18,0,0,0,0
1516,0,0,D,1,2,1298,0,2,31,28,3,8,30,18,12,28,16,12,3,0,0,0,0
1516,1,1,D,3,3,1299,2,2,19,16,0,10,21,25,24,17,-7,-4,3,0,0,0,0
1516,2,3,A,1,1,1300,0,0,19,24,0,4,20,20,21,17,-4,0,-5,0,0,0,0
1516,1,3,A,2,1,1301,1,0,24,32,2,6,28,12,16,18,2,16,-8,0,0,0,0
1516,2,3,A,0,1,1302,0,0,10,30,2,5,25,12,30,13,-17,13,-20,0,0,0,0
1516,2,0,H,4,3,1303,2,2,32,22,0,10,21,16,15,31,16,5,10,0,0,0,0
1516,2,4,A,0,3,1304,0,1,14,25,1,9,20,19,30,15,-15,1,-11,0,0,0,0
1516,1,2,A,5,3,1305,3,2,36,20,0,9,18,25,9,22,13,-7,16,1,0,1,0
1516,2,0,H,2,1,1306,2,1,29,16,2,3,15,21,18,30,12,-6,13,0,0,0,0
1516,2,0,H,3,2,1307,2,2,17,18,1,7,17,24,26,22,-4,-7,-1,0,0,0,0
1516,0,1,A,3,1,1308,2,1,22,18,1,3,14,24,19,21,2,-10,4,0,0,0,0
1516,1,1,D,0,3,1309,0,2,7,26,3,11,19,14,26,11,-15,5,-19,0,0,0,0
1516,2,3,A,1,3,1310,1,2,16,20,0,10,24,26,23,15,-8,-2,-4,0,0,0,0
1516,3,3,D,3,2,1311,2,2,22,32,1,8,32,18,18,21,3,14,-10,0,0,0,0
1516,0,1,A,1,5,1312,0,3,27,36,1,15,23,11,22,23,1,12,-9,0,1,0,1
1516,3,0,H,1,0,1313,0,0,33,8,2,3,12,27,14,28,14,-15,25,0,0,0,0
1516,0,0,D,3,0,1314,2,0,23,10,0,2,15,33,26,20,-6,-18,13,0,0,0,0
1516,0,1,A,3,1,1315,1,0,28,19,0,3,19,24,21,24,3,-5,9,0,0,0,0
1516,2,1,H,1,3,1316,0,2,35,22,3,10,21,20,13,31,18,1,13,0,0,0,0
1516,1,3,A,2,4,1317,2,2,18,35,1,12,33,15,26,17,-9,18,-17,0,0,0,0
1516,2,2,D,3,0,1318,2,0,27,14,2,1,17,34,15,20,5,-17,13,0,0,0,0
1516,2,1,H,1,2,1319,1,1,21,24,0,8,19,19,24,15,-9,0,-3,0,0,0,0
1516,2,1,H,0,1,1320,0,1,11,24,2,3,17,25,33,15,-18,-8,-13,0,0,0,0
1516,1,3,A,4,3,1321,2,2,38,24,0,9,20,26,16,36,20,-6,14,0,0,0,0
1516,1,1,D,2,3,1322,2,1,33,28,2,9,24,22,21,35,14,2,5,0,0,0,0
1516,0,2,A,2,1,1323,1,1,24,16,2,3,17,26,21,20,-1,-9,8,0,0,0,0
1516,0,1,A,1,3,1324,0,2,22,23,0,10,24,21,24,20,-4,3,-1,0,0,0,0
1516,1,5,A,0,1,1325,0,0,15,38,1,6,33,14,36,19,-17,19,-23,0,0,0,0
1516,0,1,A,5,3,1326,3,2,39,28,0,11,22,17,11,24,13,5,11,1,0,1,0
1516,1,2,A,3,1,1327,2,0,23,36,1,5,31,14,28,27,-1,17,-13,0,0,0,0
1516,0,1,A,3,1,1328,2,0,22,27,1,4,23,23,22,22,0,0,-5,0,0,0,0
1516,0,1,A,0,2,1329,0,2,8,18,3,7,18,29,30,12,-18,-11,-10,0,0,0,0
1516,1,1,D,2,5,1330,1,3,24,39,5,15,24,12,23,20,-3,12,-15,0,1,0,1
1516,3,1,H,1,3,1331,0,2,41,31,6,11,23,17,15,38,23,6,10,0,0,0,0
1516,4,2,H,3,0,1332,2,0,22,15,1,1,20,41,23,22,-1,-21,7,0,0,0,0
1516,2,2,D,1,3,1333,0,2,22,27,3,9,23,27,25,20,-5,-4,-5,0,0,0,0
1516,2,1,H,0,3,1334,0,2,14,23,5,10,28,30,34,17,-17,-2,-9,0,0,0,0
1516,1,1,D,3,1,1335,2,0,26,30,1,4,24,23,21,25,4,1,-4,0,0,0,0
1516,4,0,H,1,2,1336,1,2,19,21,3,7,19,29,26,19,-7,-10,-2,0,0,0,0
1516,2,0,H,3,4,1337,1,2,29,38,3,12,37,19,23,25,2,18,-9,0,0,0,0
1516,1,1,D,2,0,1338,2,0,34,8,2,3,12,31,22,36,14,-19,26,0,0,0,0
1516,0,4,A,1,1,1339,1,0,24,39,0,5,33,15,27,18,-9,18,-15,0,0,0,0
1516,1,1,D,3,3,1340,2,2,31,25,2,10,26,25,20,24,4,1,6,0,0,0,0
1516,2,2,D,1,3,1341,0,1,31,32,4,9,27,23,24,25,1,4,-1,0,0,0,0
1516,0,0,D,0,2,1342,0,1,15,25,4,8,21,24,45,22,-23,-3,-10,0,0,0,0
1516,2,0,H,4,3,1343,2,2,38,26,3,10,27,26,21,37,16,1,12,0,0,0,0
1516,1,1,D,5,0,1344,3,0,40,17,0,2,19,35,13,25,12,-16,23,1,0,1,0
1516,1,0,H,1,2,1345,0,2,42,35,5,8,37,23,15,37,22,14,7,0,0,0,0
1516,4,1,H,3,3,1346,2,2,28,27,3,10,26,22,29,25,-4,4,1,0,0,0,0
1516,4,1,H,2,1,1347,2,1,21,24,1,3,18,31,33,19,-14,-13,-3,0,0,0,0
1516,2,4,A,3,1,1348,2,0,23,44,1,6,41,16,32,29,-3,25,-21,0,0,0,0
1516,0,2,A,3,1,1349,2,0,32,23,2,3,22,27,21,25,4,-5,9,0,0,0,0
1516,1,1,D,0,1,1350,0,1,9,22,6,3,23,26,32,13,-19,-3,-13,0,0,0,0
1516,1,1,D,2,3,1351,1,2,26,32,2,11,25,23,24,21,-3,2,-6,0,0,0,0
1516,1,1,D,0,2,1352,0,2,18,24,2,7,23,34,36,20,-16,-11,-6,0,0,0,0
1516,3,1,H,2,0,1353,2,0,35,16,2,1,22,45,24,37,13,-23,19,0,0,0,0
1516,3,2,H,1,3,1354,0,2,26,23,3,10,31,36,27,24,-3,-5,3,0,0,0,0
1516,0,4,A,3,1,1355,2,0,27,45,1,5,38,15,26,27,1,23,-18,0,0,0,0
1516,0,0,D,1,4,1356,1,2,23,41,3,12,39,21,27,24,-3,18,-18,0,0,0,0
1516,3,0,H,3,5,1357,1,3,33,41,3,15,26,14,25,29,4,12,-8,0,1,0,1
1516,5,1,H,1,1,1358,0,0,47,32,3,4,27,26,18,45,27,1,15,0,0,0,0
1516,0,0,D,3,0,1359,2,0,26,10,1,3,14,33,28,27,-1,-19,16,0,0,0,0
1516,0,0,D,1,3,1360,1,2,24,31,3,9,29,30,35,19,-16,-1,-7,0,0,0,0
1516,0,2,A,3,2,1361,2,2,33,38,2,8,40,25,24,26,2,15,-5,0,0,0,0
1516,1,1,D,1,1,1362,0,1,32,25,1,3,19,35,31,28,-3,-16,7,0,0,0,0
1516,2,1,H,4,0,1363,2,0,42,19,0,2,21,37,21,39,18,-16,23,0,0,0,0
1516,1,0,H,0,1,1364,0,0,16,29,4,3,27,29,48,23,-25,-2,-13,0,0,0,0
1516,1,0,H,5,3,1365,3,2,41,27,0,10,27,30,17,26,9,-3,14,1,0,1,0
1516,1,0,H,1,1,1366,0,1,48,24,2,3,24,27,15,42,27,-3,24,0,0,0,0
1516,0,2,A,3,1,1367,2,0,32,50,3,6,50,19,30,29,-1,31,-18,0,0,0,0
1516,0,2,A,2,3,1368,2,1,25,36,4,9,32,25,35,24,-11,7,-11,0,0,0,0
1516,2,2,D,3,3,1369,2,2,23,27,4,10,27,28,39,33,-6,-1,-4,0,0,0,0
1516,2,1,H,0,2,1370,0,1,11,27,3,8,22,25,33,14,-19,-3,-16,0,0,0,0
1516,1,1,D,1,4,1371,0,2,29,45,3,12,41,22,30,27,-3,19,-16,0,0,0,0
1516,0,0,D,1,3,1372,1,2,24,32,3,9,29,32,28,24,-4,-3,-8,0,0,0,0
1516,0,0,D,2,1,1373,1,0,27,33,2,4,29,32,27,23,-4,-3,-6,0,0,0,0
1516,0,2,A,0,1,1374,0,0,19,51,1,5,43,15,48,24,-24,28,-32,0,0,0,0
1516,1,1,D,3,1,1375,1,1,39,26,0,3,20,36,25,34,9,-16,13,0,0,0,0
1516,1,0,H,1,0,1376,0,0,53,19,3,2,22,39,19,52,33,-17,34,0,0,0,0
1516,2,1,H,2,3,1377,2,2,41,24,5,10,35,41,25,42,17,-6,17,0,0,0,0
1516,2,2,D,3,2,1378,2,2,33,25,2,7,24,37,26,26,0,-13,8,0,0,0,0
1516,1,2,A,3,3,1379,2,2,28,27,4,10,27,31,30,29,-1,-4,1,0,0,0,0
1516,3,3,D,0,5,1380,0,3,14,44,6,15,27,17,34,16,-18,10,-30,0,1,0,1
1516,5,2,H,3,0,1381,2,0,33,15,0,3,19,37,32,29,-3,-18,18,0,0,0,0
1516,1,3,A,0,2,1382,0,2,19,44,2,8,44,26,40,22,-18,18,-25,0,0,0,0
1516,1,1,D,3,3,1383,2,2,30,34,1,11,28,28,32,29,-3,0,-4,0,0,0,0
1516,1,2,A,1,0,1384,0,0,34,19,1,1,24,50,32,29,-3,-26,15,0,0,0,0
1516,1,0,H,1,1,1385,0,0,54,56,2,6,53,19,15,45,30,34,-2,0,0,0,0
1516,2,1,H,4,5,1386,2,3,46,45,0,15,30,20,23,42,19,10,1,0,1,0,1
1516,2,1,H,3,1,1387,1,1,40,25,0,3,24,28,26,35,9,-4,15,0,0,0,0
1516,1,3,A,2,3,1388,2,2,26,28,1,10,30,32,39,26,-13,-2,-2,0,0,0,0
1516,0,0,D,3,2,1389,2,1,24,28,1,8,23,27,43,36,-7,-4,-4,0,0,0,0
1516,0,1,A,1,1,1390,1,0,27,30,0,3,28,31,37,21,-16,-3,-3,0,0,0,0
1516,0,0,D,1,1,1391,0,0,33,57,0,5,46,15,31,29,-2,31,-24,0,0,0,0
1516,3,1,H,5,3,1392,3,2,45,25,0,10,36,43,22,31,9,-7,20,1,0,1,0
1516,3,1,H,0,3,1393,0,2,15,31,3,10,30,33,42,21,-21,-3,-16,0,0,0,0
1516,2,3,A,2,4,1394,1,2,29,49,2,12,44,24,27,23,-4,20,-20,0,0,0,0
1516,0,0,D,0,3,1395,0,2,22,36,1,9,34,34,51,26,-25,0,-14,0,0,0,0
1516,2,1,H,1,1,1396,1,1,25,27,0,3,21,38,30,25,-5,-17,-2,0,0,0,0
1516,5,0,H,2,2,1397,2,2,47,26,2,7,27,42,27,47,20,-15,21,0,0,0,0
1516,3,2,H,3,1,1398,2,0,35,34,2,4,30,34,29,29,0,-4,1,0,0,0,0
1516,0,0,D,3,0,1399,2,0,31,19,1,2,23,43,33,33,0,-20,12,0,0,0,0
1516,1,1,D,1,3,1400,0,1,56,43,3,9,37,27,20,53,33,10,13,0,0,0,0
1516,1,3,A,1,2,1401,0,2,34,50,1,8,52,27,37,32,-5,25,-16,0,0,0,0
1516,1,0,H,3,3,1402,1,2,44,32,0,10,33,33,28,38,10,0,12,0,0,0,0
1516,1,1,D,0,2,1403,0,1,20,29,2,8,25,30,43,23,-20,-5,-9,0,0,0,0
1516,1,0,H,3,1,1404,2,1,31,28,1,3,27,31,36,31,-5,-4,3,0,0,0,0
1516,2,0,H,1,5,1405,0,3,58,48,2,15,34,23,15,46,31,11,10,0,1,0,1
1516,0,0,D,2,1,1406,2,0,26,34,1,3,29,31,47,27,-20,-2,-8,0,0,0,0
1516,2,0,H,3,0,1407,2,0,25,23,1,1,26,51,46,37,-9,-25,2,0,0,0,0
1516,2,0,H,1,0,1408,1,0,27,18,0,3,24,43,40,22,-18,-19,9,0,0,0,0
1516,1,1,D,4,1,1409,2,0,52,57,0,6,54,21,26,47,21,33,-5,0,0,0,0
1516,0,2,A,3,3,1410,2,2,37,38,0,11,32,31,34,34,0,1,-1,0,0,0,0
1516,4,1,H,2,4,1411,2,2,53,53,2,12,48,27,28,55,27,21,0,0,0,0,0
1516,3,1,H,1,3,1412,0,2,58,34,3,10,32,36,22,55,33,-4,24,0,0,0,0
1516,0,3,A,0,3,1413,0,2,18,28,3,10,39,46,45,24,-21,-7,-10,0,0,0,0
1516,0,2,A,2,1,1414,1,0,30,61,2,5,48,15,31,26,-5,33,-31,0,0,0,0
1516,0,0,D,1,0,1415,0,0,35,21,0,2,24,44,31,29,-2,-20,14,0,0,0,0
1516,2,0,H,0,1,1416,0,1,23,30,1,3,24,40,53,26,-27,-16,-7,0,0,0,0
1516,1,0,H,1,1,1417,1,0,28,34,0,4,33,40,32,27,-5,-7,-6,0,0,0,0
1516,3,1,H,5,2,1418,3,2,48,27,0,7,27,47,25,34,9,-20,21,1,0,1,0
1516,2,0,H,3,3,1419,2,1,41,47,2,9,39,28,31,34,3,11,-6,0,0,0,0
1516,1,1,D,3,3,1420,2,2,32,37,1,9,34,36,34,33,-1,-2,-5,0,0,0,0
1516,1,0,H,1,3,1421,0,2,64,44,2,11,36,31,15,50,35,5,20,0,0,0,0
1516,1,1,D,1,3,1422,0,2,34,31,1,10,42,46,41,33,-8,-4,3,0,0,0,0
1516,2,1,H,5,1,1423,3,0,51,36,0,3,29,31,26,37,11,-2,15,1,0,1,0
1516,2,1,H,0,0,1424,0,0,22,26,2,1,28,53,44,24,-20,-25,-4,0,0,0,0
1516,0,0,D,3,3,1425,2,1,34,47,1,9,39,30,39,33,-6,9,-13,0,0,0,0
1516,1,1,D,4,0,1426,2,0,53,18,0,3,24,48,31,49,18,-24,35,0,0,0,0
1516,3,2,H,1,3,1427,1,2,31,33,0,10,34,35,32,28,-4,-1,-2,0,0,0,0
1516,2,0,H,3,2,1428,2,1,38,30,0,8,26,33,37,35,-2,-7,8,0,0,0,0
1516,0,1,A,2,1,1429,2,0,27,61,1,6,58,23,50,28,-22,35,-34,0,0,0,0
1516,1,2,A,1,2,1430,1,2,30,56,0,8,59,29,42,24,-18,30,-26,0,0,0,0
1516,0,0,D,1,2,1431,0,2,35,27,1,7,28,51,42,34,-8,-23,8,0,0,0,0
1516,1,1,D,2,5,1432,2,3,59,54,2,15,39,27,30,61,31,12,5,0,1,0,1
1516,2,0,H,2,1,1433,1,0,30,36,2,3,30,33,35,26,-9,-3,-6,0,0,0,0
1516,0,0,D,0,4,1434,0,2,26,54,1,12,50,32,55,29,-26,18,-28,0,0,0,0
1516,1,1,D,3,3,1435,1,2,48,41,0,9,37,37,30,39,9,0,7,0,0,0,0
1516,3,1,H,1,1,1436,0,1,64,34,3,3,31,34,23,59,36,-3,30,0,0,0,0
1516,0,1,A,3,3,1437,2,2,32,35,1,10,33,39,47,43,-4,-6,-3,0,0,0,0
1516,1,1,D,3,1,1438,2,1,44,30,2,3,25,44,32,36,4,-19,14,0,0,0,0
1516,1,4,A,3,1,1439,2,0,33,67,1,5,51,15,38,36,-2,36,-34,0,0,0,0
1516,1,2,A,0,0,1440,0,0,19,25,3,2,26,45,49,25,-24,-19,-6,0,0,0,0
1516,1,3,A,0,3,1441,0,2,28,45,2,11,37,33,46,28,-18,4,-17,0,0,0,0
1516,1,0,H,1,1,1442,0,0,70,36,2,4,34,42,16,55,39,-8,34,0,0,0,0
1516,2,1,H,2,3,1443,1,1,33,49,2,9,40,31,35,28,-7,9,-16,0,0,0,0
1516,3,1,H,3,2,1444,2,2,38,28,1,7,28,51,39,34,-5,-23,10,0,0,0,0
1516,1,1,D,4,3,1445,2,2,55,32,0,10,43,48,32,50,18,-5,23,0,0,0,0
1516,4,0,H,1,0,1446,1,0,34,27,0,1,29,55,37,32,-5,-26,7,0,0,0,0
1516,1,2,A,5,3,1447,3,2,55,33,0,10,37,42,28,40,12,-5,22,1,0,1,0
1516,1,4,A,3,2,1448,2,2,42,60,0,8,62,31,38,38,0,31,-18,0,0,0,0
1516,3,1,H,1,1,1449,1,0,31,67,0,6,62,24,45,26,-19,38,-36,0,0,0,0
1516,0,1,A,1,0,1450,0,0,36,19,0,3,26,51,35,30,-5,-25,17,0,0,0,0
1516,1,0,H,3,0,1451,2,0,41,28,1,2,29,49,40,37,-3,-20,13,0,0,0,0
1516,0,1,A,0,5,1452,0,3,27,55,1,15,41,30,59,29,-30,11,-28,0,1,0,1
1516,1,2,A,3,1,1453,1,0,49,73,0,5,56,16,33,41,8,40,-24,0,0,0,0
1516,0,1,A,3,1,1454,2,1,48,37,2,3,36,37,34,40,6,-1,11,0,0,0,0
1516,2,0,H,1,4,1455,0,2,36,56,1,12,51,33,43,34,-9,18,-20,0,0,0,0
1516,3,0,H,1,0,1456,0,0,67,22,3,3,27,51,27,63,36,-24,45,0,0,0,0
1516,0,3,A,2,3,1457,2,2,28,42,1,9,39,42,54,29,-25,-3,-14,0,0,0,0
1516,2,0,H,3,1,1458,2,1,33,34,1,3,29,46,49,44,-5,-17,-1,0,0,0,0
1516,2,1,H,3,2,1459,2,1,36,36,1,8,30,36,43,39,-4,-6,0,0,0,0,0
1516,1,1,D,2,1,1460,2,0,63,36,2,3,30,36,32,66,34,-6,27,0,0,0,0
1516,0,1,A,1,3,1461,0,2,37,39,0,10,41,44,37,31,-6,-3,-2,0,0,0,0
1516,4,1,H,0,1,1462,0,1,28,40,2,3,37,37,50,29,-21,0,-12,0,0,0,0
1516,2,0,H,5,1,1463,3,0,58,70,0,6,66,27,30,42,12,39,-12,1,0,1,0
1516,3,3,D,2,2,1464,1,2,36,64,2,8,67,33,38,31,-7,34,-28,0,0,0,0
1516,3,1,H,4,3,1465,2,2,56,48,0,11,40,35,35,51,16,5,8,0,0,0,0
1516,4,0,H,1,2,1466,0,2,76,28,2,7,29,57,17,58,41,-28,48,0,0,0,0
1516,2,0,H,3,1,1467,2,0,45,39,0,4,36,43,42,42,0,-7,6,0,0,0,0
1516,0,1,A,3,3,1468,2,1,36,49,1,9,42,35,49,46,-3,7,-13,0,0,0,0
1516,0,0,D,1,3,1469,1,2,34,44,0,10,38,40,48,29,-19,-2,-10,0,0,0,0
1516,1,2,A,0,0,1470,0,0,22,27,3,1,29,60,54,27,-27,-31,-5,0,0,0,0
1516,6,0,H,1,1,1471,0,0,70,37,3,3,31,38,29,66,37,-7,33,0,0,0,0
1516,5,1,H,3,0,1472,2,0,45,30,1,1,31,61,40,38,-2,-30,15,0,0,0,0
1516,1,0,H,1,0,1473,0,0,39,22,1,3,28,56,45,36,-9,-28,17,0,0,0,0
1516,1,0,H,1,5,1474,1,3,40,61,0,15,44,30,41,38,-3,14,-21,0,1,0,1
1516,3,0,H,1,3,1475,0,2,79,48,2,9,44,42,17,62,45,2,31,0,0,0,0
1516,2,2,D,2,2,1476,2,1,28,37,1,8,34,41,61,29,-32,-7,-9,0,0,0,0
1516,3,2,H,2,3,1477,2,2,65,42,2,10,42,44,36,70,34,-2,23,0,0,0,0
1516,0,0,D,3,3,1478,2,2,48,36,2,10,46,50,38,41,3,-4,12,0,0,0,0
1516,2,1,H,1,4,1479,1,2,35,59,0,12,54,36,48,29,-19,18,-24,0,0,0,0
1516,0,0,D,3,0,1480,1,0,52,31,0,2,33,51,35,43,8,-18,21,0,0,0,0
1516,3,1,H,5,1,1481,3,1,61,38,0,3,31,49,31,44,13,-18,23,1,0,1,0
1516,1,0,H,2,3,1482,1,2,38,48,2,10,43,41,43,36,-7,2,-10,0,0,0,0
1516,2,0,H,1,1,1483,0,1,37,43,0,3,39,41,44,31,-13,-2,-6,0,0,0,0
1516,1,2,A,4,1,1484,2,0,59,82,0,5,65,17,38,55,17,48,-23,0,0,0,0
1516,0,2,A,0,2,1485,0,2,30,29,1,7,31,63,66,32,-34,-32,1,0,0,0,0
1516,2,1,H,3,3,1486,2,2,37,48,1,9,44,45,50,46,-4,-1,-11,0,0,0,0
1516,1,3,A,3,3,1487,2,2,42,49,1,11,41,38,47,44,-3,3,-7,0,0,0,0
1516,1,0,H,0,1,1488,0,0,32,42,2,4,37,45,51,33,-18,-8,-10,0,0,0,0
1516,1,0,H,2,1,1489,2,0,68,73,2,6,72,29,38,73,35,43,-5,0,0,0,0
1516,2,1,H,0,3,1490,0,1,22,53,3,9,43,35,57,28,-29,8,-31,0,0,0,0
1516,0,0,D,3,4,1491,2,2,48,59,1,12,56,40,42,43,1,16,-11,0,0,0,0
1516,1,5,A,1,3,1492,1,2,38,42,0,10,45,50,52,32,-20,-5,-4,0,0,0,0
1516,0,0,D,1,1,1493,0,0,42,40,1,3,33,44,46,37,-9,-11,2,0,0,0,0
1516,2,0,H,1,0,1494,0,0,85,35,2,2,34,51,18,67,49,-17,50,0,0,0,0
1516,2,0,H,3,5,1495,2,3,48,64,0,15,47,32,47,45,-2,15,-16,0,1,0,1
1516,3,3,D,3,0,1496,1,0,53,30,0,1,32,68,37,44,7,-36,23,0,0,0,0
1516,2,0,H,2,3,1497,2,2,32,40,1,10,48,51,63,33,-30,-3,-8,0,0,0,0
1516,1,0,H,3,0,1498,2,0,52,25,2,3,30,58,39,44,5,-28,27,0,0,0,0
1516,2,3,A,1,2,1499,1,2,43,71,0,8,74,38,43,39,-4,36,-28,0,0,0,0
1516,2,1,H,1,2,1500,0,1,73,41,3,8,37,43,30,72,42,-6,32,0,0,0,0
1516,0,1,A,1,3,1501,0,1,41,54,0,9,47,40,44,33,-11,7,-13,0,0,0,0
1516,2,1,H,5,1,1502,3,0,64,43,0,4,37,46,34,47,13,-9,21,1,0,1,0
1516,1,1,D,2,1,1503,1,1,41,38,2,3,33,57,45,38,-7,-24,3,0,0,0,0
1516,1,3,A,0,3,1504,0,2,35,51,2,9,47,47,53,34,-19,0,-16,0,0,0,0
1516,0,0,D,4,2,1505,2,2,60,35,0,7,35,63,40,56,16,-28,25,0,0,0,0
1516,0,1,A,0,3,1506,0,2,31,55,1,11,45,39,71,35,-36,6,-24,0,0,0,0
1516,3,0,H,2,3,1507,2,2,74,49,2,10,43,42,40,77,37,1,25,0,0,0,0
1516,0,3,A,3,1,1508,2,1,40,43,1,3,41,46,53,48,-5,-5,-3,0,0,0,0
1516,1,2,A,3,1,1509,2,0,45,76,1,6,74,31,51,50,-1,43,-31,0,0,0,0
1516,2,1,H,0,1,1510,0,0,25,88,3,5,69,18,59,30,-29,51,-63,0,0,0,0
1516,5,0,H,1,3,1511,0,2,88,40,2,10,48,56,20,70,50,-8,48,0,0,0,0
1516,1,3,A,3,2,1512,1,2,57,77,0,8,80,40,40,48,8,40,-20,0,0,0,0
1516,4,0,H,1,0,1513,0,0,79,31,3,1,35,72,32,76,44,-37,48,0,0,0,0
1516,3,1,H,3,5,1514,2,3,58,67,2,15,49,35,39,46,7,14,-9,0,1,0,1
1516,0,0,D,3,1,1515,2,0,49,41,1,3,33,45,45,43,-2,-12,8,0,0,0,0
1516,2,1,H,1,3,1516,0,2,43,45,1,10,51,53,48,38,-10,-2,-2,0,0,0,0
1516,1,2,A,1,2,1517,1,1,46,42,0,8,39,46,46,44,-2,-7,4,0,0,0,0
1516,2,4,A,3,4,1518,2,2,54,61,0,12,56,40,48,50,2,16,-7,0,0,0,0
1516,3,2,H,2,0,1519,2,0,36,28,1,3,32,60,63,35,-28,-28,8,0,0,0,0
1516,1,2,A,1,0,1520,1,0,39,35,0,2,35,56,58,34,-24,-21,4,0,0,0,0
1617,2,1,H,0,0,1521,0,0,0,0,0,0,0,0,0,0,0,0,0,0,0,0,0
1617,4,0,H,0,0,1522,0,0,0,0,0,0,0,0,0,0,0,0,0,0,0,0,0
1617,3,4,A,0,0,1523,0,0,0,0,0,0,0,0,0,0,0,0,0,0,0,0,0
1617,1,0,H,0,0,1524,0,0,0,0,0,0,0,0,0,0,0,0,0,0,0,0,0
1617,2,0,H,0,0,1525,0,0,0,0,0,0,0,0,0,0,0,0,0,0,0,0,0
1617,0,1,A,0,0,1526,0,0,0,0,0,0,0,0,0,0,0,0,0,0,0,0,0
1617,3,1,H,0,0,1527,0,0,0,0,0,0,0,0,0,0,0,0,0,0,0,0,0
1617,3,2,H,0,0,1528,0,0,0,0,0,0,0,0,0,0,0,0,0,0,0,0,0
1617,0,1,A,0,0,1529,0,0,0,0,0,0,0,0,0,0,0,0,0,0,0,0,0
1617,2,2,D,0,0,1530,0,0,0,0,0,0,0,0,0,0,0,0,0,0,0,0,0
1617,0,1,A,1,1,1531,1,1,3,3,0,3,2,1,3,4,1,1,0,0,0,0,0
1617,4,2,H,0,1,1532,0,1,1,3,1,3,3,2,2,2,0,1,-2,0,0,0,0
1617,2,2,D,0,1,1533,0,1,0,3,0,3,4,0,3,1,-2,4,-3,0,0,0,0
1617,1,3,A,0,1,1534,0,1,0,3,0,3,3,1,1,0,-1,2,-3,0,0,0,0
1617,1,0,H,0,1,1535,0,1,0,3,0,3,2,0,2,1,-1,2,-3,0,0,0,0
1617,1,1,D,0,0,1536,0,0,0,0,0,0,0,1,2,0,-2,-1,0,0,0,0,0
1617,2,1,H,1,0,1537,1,0,3,0,0,0,3,4,0,1,1,-1,3,0,0,0,0
1617,0,3,A,1,0,1538,1,0,3,1,0,1,2,2,0,1,1,0,2,0,0,0,0
1617,5,1,H,0,1,1539,0,1,0,3,0,3,1,0,3,2,-1,1,-3,0,0,0,0
1617,2,0,H,0,0,1540,0,0,0,0,0,0,0,1,4,0,-4,-1,0,0,0,0,0
1617,3,1,H,2,1,1541,2,1,6,3,0,3,1,3,1,3,2,-2,3,0,0,0,0
1617,0,3,A,0,1,1542,0,1,1,4,1,4,6,4,2,1,-1,2,-3,0,0,0,0
1617,2,1,H,0,1,1543,0,1,0,3,0,3,7,4,6,4,-2,3,-3,0,0,0,0
1617,2,1,H,1,0,1544,1,0,3,1,0,1,3,5,5,2,-3,-2,2,0,0,0,0
1617,1,1,D,1,1,1545,1,1,3,3,0,3,4,4,1,2,1,0,0,0,0,0,0
1617,0,1,A,1,1,1546,1,1,3,3,0,3,2,4,6,5,-1,-2,0,0,0,0,0
1617,1,2,A,1,0,1547,1,0,4,1,1,1,1,3,2,5,3,-2,3,0,0,0,0
1617,3,2,H,1,2,1548,1,2,4,6,1,6,3,1,2,6,4,2,-2,0,0,0,0
1617,2,1,H,0,0,1549,0,0,0,0,0,0,1,4,3,0,-3,-3,0,0,0,0,0
1617,0,1,A,2,1,1550,2,1,6,3,0,3,5,7,4,5,1,-2,3,0,0,0,0
1617,3,0,H,1,1,1551,1,1,4,4,1,4,6,4,5,5,0,2,0,0,0,0,0
1617,3,1,H,2,2,1552,2,2,7,6,1,6,4,6,4,9,5,-2,1,0,0,0,0
1617,3,0,H,0,1,1553,0,1,1,3,1,3,6,7,7,4,-3,-1,-2,0,0,0,0
1617,1,1,D,0,0,1554,0,0,0,1,0,1,1,5,6,2,-4,-4,-1,0,0,0,0
1617,1,0,H,1,2,1555,1,2,3,7,0,7,9,4,2,2,0,5,-4,0,0,0,0
1617,2,1,H,1,3,1556,1,3,4,9,1,9,6,2,4,3,-1,4,-5,0,0,0,1
1617,2,0,H,1,2,1557,1,2,3,6,0,6,6,2,6,2,-4,4,-3,0,0,0,0
1617,0,0,D,1,1,1558,1,1,3,3,0,3,2,4,6,8,2,-2,0,0,0,0,0
1617,1,2,A,2,1,1559,2,1,6,4,0,4,3,2,4,3,-1,1,2,0,0,0,0
1617,2,0,H,2,2,1560,1,1,6,7,0,7,8,5,7,6,-1,3,-1,0,0,0,0
1617,0,1,A,1,0,1561,1,0,3,2,0,2,2,6,10,6,-4,-4,1,0,0,0,0
1617,2,0,H,2,2,1562,2,2,6,6,0,6,5,5,9,5,-4,0,0,0,0,0,0
1617,2,1,H,2,2,1563,1,1,7,6,1,6,4,6,3,5,2,-2,1,0,0,0,0
1617,0,2,A,1,2,1564,1,1,4,7,1,7,5,5,4,2,-2,0,-3,0,0,0,0
1617,0,0,D,2,3,1565,2,2,6,10,0,10,12,5,4,6,2,7,-4,0,0,0,0
1617,4,0,H,3,1,1566,3,0,9,4,0,4,7,7,4,7,3,0,5,0,0,1,0
1617,0,0,D,1,1,1567,1,1,4,4,1,4,8,6,7,6,-1,2,0,0,0,0,0
1617,4,0,H,2,0,1568,2,0,7,1,1,1,3,7,5,9,4,-4,6,0,0,0,0
1617,2,2,D,2,2,1569,2,2,6,6,0,6,3,2,6,4,-2,1,0,0,0,0,0
1617,2,0,H,3,3,1570,2,1,11,10,2,10,7,4,5,12,7,3,1,0,0,0,0
1617,0,1,A,1,4,1571,0,3,5,12,2,12,11,4,6,3,-3,7,-7,0,0,0,1
1617,0,0,D,2,3,1572,2,1,7,9,1,9,8,7,4,5,1,1,-2,0,0,0,0
1617,1,1,D,2,1,1573,2,1,7,5,1,5,6,7,4,6,2,-1,2,0,0,0,0
1617,1,1,D,3,3,1574,1,2,10,9,1,9,7,9,5,7,2,-2,1,0,0,0,0
1617,2,0,H,2,1,1575,1,1,7,4,1,4,2,6,7,8,1,-4,3,0,0,0,0
1617,1,0,H,2,2,1576,1,2,6,7,0,7,6,8,8,5,-3,-2,-1,0,0,0,0
1617,3,1,H,1,3,1577,1,2,5,10,2,10,13,5,6,8,2,8,-5,0,0,0,0
1617,2,1,H,1,2,1578,0,2,4,6,1,6,5,7,11,7,-4,-2,-2,0,0,0,0
1617,1,3,A,0,1,1579,0,1,1,3,1,3,6,11,11,3,-8,-5,-2,0,0,0,0
1617,0,2,A,1,3,1580,1,1,6,10,2,10,7,6,8,7,-1,1,-4,0,0,0,0
1617,0,3,A,2,2,1581,2,1,7,10,1,7,10,7,9,6,-3,3,-3,0,0,0,0
1617,1,0,H,1,3,1582,1,2,6,14,0,11,14,5,12,9,-3,9,-8,0,0,0,0
1617,0,1,A,3,2,1583,2,2,10,8,0,8,7,5,10,8,-2,2,2,0,0,0,0
1617,2,1,H,1,0,1584,0,0,7,1,1,1,4,14,12,9,-3,-10,6,0,0,0,0
1617,0,3,A,1,4,1585,1,3,4,15,1,12,12,4,8,2,-6,8,-11,0,0,0,1
1617,4,3,H,3,2,1586,1,1,10,9,0,6,6,8,7,8,1,-2,1,0,0,0,0
1617,2,1,H,3,3,1587,2,1,10,11,1,10,8,6,8,14,6,2,-1,0,0,0,0
1617,1,1,D,2,1,1588,2,0,6,5,0,5,3,7,9,6,-3,-4,1,0,0,0,0
1617,2,1,H,1,2,1589,1,2,8,8,2,8,5,4,7,11,4,1,0,0,0,0,0
1617,2,1,H,4,2,1590,3,2,18,7,0,7,6,12,4,15,11,-6,11,0,0,1,0
1617,1,3,A,3,3,1591,2,2,14,13,2,10,16,9,6,14,8,7,1,0,0,0,0
1617,1,1,D,1,2,1592,1,2,6,7,2,6,7,10,10,7,-3,-3,-1,0,0,0,0
1617,1,3,A,3,3,1593,1,1,13,13,1,9,12,10,6,9,3,2,0,0,0,0,0
1617,0,0,D,2,1,1594,2,1,8,9,2,3,10,12,6,6,0,-2,-1,0,0,0,0
1617,0,0,D,2,1,1595,2,1,11,4,2,4,2,11,5,8,3,-9,7,0,0,0,0
1617,1,2,A,3,1,1596,1,0,11,10,1,4,11,13,8,9,1,-2,1,0,0,0,0
1617,1,1,D,2,3,1597,1,2,13,10,1,9,8,11,7,13,6,-3,3,0,0,0,0
1617,2,1,H,2,0,1598,1,0,9,1,0,1,5,16,12,9,-3,-11,8,0,0,0,0
1617,1,4,A,1,1,1599,0,1,6,11,2,5,13,8,8,4,-4,5,-5,0,0,0,0
1617,1,0,H,3,4,1600,1,3,16,21,0,12,17,5,11,15,4,12,-5,0,0,0,1
1617,2,1,H,2,2,1601,2,2,8,12,0,8,8,5,11,8,-3,3,-4,0,0,0,0
1617,2,1,H,1,3,1602,1,1,10,11,0,10,10,10,12,10,-2,0,-1,0,0,0,0
1617,1,1,D,3,2,1603,2,1,11,12,0,6,11,13,12,9,-3,-2,-1,0,0,0,0
1617,3,5,A,1,2,1604,0,2,13,9,1,8,6,6,14,13,-1,0,4,0,0,0,0
1617,1,2,A,0,3,1605,0,2,1,14,1,11,15,9,18,6,-12,6,-13,0,0,0,0
1617,0,0,D,1,3,1606,1,1,5,13,1,10,10,9,11,2,-9,1,-8,0,0,0,0
1617,4,1,H,3,1,1607,2,0,16,6,1,5,5,12,10,19,9,-7,10,0,0,0,0
1617,2,2,D,1,2,1608,1,1,14,14,2,7,14,8,9,17,8,6,0,0,0,0,0
1617,3,1,H,2,1,1609,2,1,7,7,1,5,8,11,14,7,-7,-3,0,0,0,0,0
1617,3,0,H,2,3,1610,2,1,12,19,2,9,16,11,7,9,2,5,-7,0,0,0,0
1617,1,1,D,3,3,1611,1,2,14,12,1,9,10,13,9,10,1,-3,2,0,0,0,0
1617,1,1,D,2,0,1612,2,0,12,1,2,1,7,20,9,11,2,-13,11,0,0,0,0
1617,2,1,H,3,1,1613,1,1,11,15,1,5,19,11,12,11,-1,8,-4,0,0,0,0
1617,4,1,H,4,2,1614,3,2,21,11,0,6,10,12,6,17,11,-2,10,0,0,1,0
1617,4,1,H,2,1,1615,1,0,15,13,1,4,16,19,10,16,6,-3,2,0,0,0,0
1617,2,0,H,3,1,1616,2,1,17,6,2,4,2,11,10,17,7,-9,11,0,0,0,0
1617,0,1,A,1,1,1617,1,1,7,13,2,3,12,13,14,9,-5,-1,-6,0,0,0,0
1617,1,3,A,2,3,1618,1,2,13,19,0,10,23,11,14,12,-2,12,-6,0,0,0,0
1617,1,3,A,1,2,1619,0,2,6,10,2,7,10,15,16,6,-10,-5,-4,0,0,0,0
1617,0,1,A,3,2,1620,2,2,13,13,0,8,12,10,14,11,-3,2,0,0,0,0,0
1617,2,1,H,4,3,1621,3,2,24,20,0,11,19,10,7,21,14,9,4,0,0,1,0
1617,3,0,H,1,2,1622,1,2,16,15,0,8,12,7,13,13,0,5,1,0,0,0,0
1617,2,0,H,0,3,1623,0,1,2,15,1,10,11,10,21,8,-13,1,-13,0,0,0,0
1617,0,0,D,1,3,1624,1,2,6,22,1,10,26,12,13,2,-11,14,-16,0,0,0,0
1617,2,1,H,2,2,1625,1,1,18,13,1,6,13,17,11,20,9,-4,5,0,0,0,0
1617,1,0,H,3,1,1626,1,1,19,7,0,5,9,15,14,16,2,-6,12,0,0,0,0
1617,1,0,H,2,3,1627,2,1,11,14,0,10,13,13,16,11,-5,0,-3,0,0,0,0
1617,2,1,H,1,1,1628,0,0,13,6,1,5,7,19,23,17,-6,-12,7,0,0,0,0
1617,2,2,D,2,1,1629,2,1,13,15,1,5,20,13,16,13,-3,7,-2,0,0,0,0
1617,1,1,D,3,2,1630,2,1,20,21,2,7,22,12,12,20,8,10,-1,0,0,0,0
1617,5,1,H,1,1,1631,1,0,16,16,2,4,19,24,15,22,7,-5,0,0,0,0,0
1617,1,2,A,3,4,1632,1,3,15,27,1,12,23,8,12,11,-1,15,-12,0,0,0,1
1617,1,1,D,2,2,1633,2,2,16,14,2,6,12,16,10,13,3,-4,2,0,0,0,0
1617,1,1,D,2,2,1634,2,2,15,14,2,7,15,18,10,12,2,-3,1,0,0,0,0
1617,3,0,H,3,0,1635,1,0,14,5,1,1,10,21,14,13,-1,-11,9,0,0,0,0
1617,1,2,A,1,3,1636,0,1,6,22,2,9,17,14,21,8,-13,3,-16,0,0,0,0
1617,0,4,A,1,1,1637,1,1,7,7,2,4,2,13,16,9,-7,-11,0,0,0,0,0
1617,3,0,H,3,3,1638,2,2,23,13,1,9,11,15,12,26,14,-4,10,0,0,0,0
1617,0,3,A,2,1,1639,1,1,13,19,0,3,16,13,19,14,-5,3,-6,0,0,0,0
1617,1,0,H,3,1,1640,1,0,15,16,1,4,20,29,14,12,-2,-9,-1,0,0,0,0
1617,3,0,H,4,1,1641,3,1,30,7,0,5,9,20,9,25,16,-11,23,0,0,1,0
1617,1,2,A,2,3,1642,2,2,15,21,1,11,21,13,19,16,-3,8,-6,0,0,0,0
1617,2,1,H,1,3,1643,1,2,22,26,0,10,29,12,13,19,6,17,-4,0,0,0,0
1617,3,1,H,3,1,1644,2,0,13,6,0,5,9,23,18,11,-7,-14,7,0,0,0,0
1617,0,2,A,0,1,1645,0,1,5,19,1,5,27,16,24,10,-14,11,-14,0,0,0,0
1617,0,4,A,1,2,1646,1,2,10,17,1,8,14,11,13,6,-7,3,-7,0,0,0,0
1617,3,1,H,2,2,1647,1,2,22,16,1,8,13,11,13,23,10,2,6,0,0,0,0
1617,2,2,D,3,3,1648,1,1,25,17,0,10,16,14,15,19,4,2,8,0,0,0,0
1617,3,2,H,2,2,1649,2,1,15,13,0,6,14,22,17,13,-4,-8,2,0,0,0,0
1617,1,4,A,1,3,1650,1,1,10,26,1,9,21,17,17,6,-11,4,-16,0,0,0,0
1617,2,1,H,1,3,1651,1,1,22,18,2,10,13,14,16,29,13,-1,4,0,0,0,0
1617,0,2,A,3,1,1652,2,1,16,25,0,3,21,14,19,14,-5,7,-9,0,0,0,0
1617,2,1,H,1,2,1653,0,2,16,15,1,7,17,21,30,20,-10,-4,1,0,0,0,0
1617,1,1,D,0,2,1654,0,2,5,18,1,6,16,19,26,10,-16,-3,-13,0,0,0,0
1617,3,1,H,2,4,1655,2,3,16,33,2,12,28,9,14,14,0,19,-17,0,0,0,1
1617,0,1,A,1,2,1656,0,1,6,25,2,7,26,14,26,10,-16,12,-19,0,0,0,0
1617,3,2,H,3,1,1657,2,1,26,7,1,5,9,23,14,30,16,-14,19,0,0,0,0
1617,4,2,H,3,2,1658,1,2,18,20,1,8,18,11,16,18,2,7,-2,0,0,0,0
1617,1,1,D,3,2,1659,2,1,24,13,2,6,16,25,14,23,9,-9,11,0,0,0,0
1617,3,0,H,3,3,1660,2,1,25,21,2,10,22,18,15,24,9,4,4,0,0,0,0
1617,3,1,H,4,1,1661,3,1,33,28,0,3,23,14,12,29,17,9,5,0,0,1,0
1617,2,1,H,2,1,1662,2,0,20,6,2,5,10,27,15,20,5,-17,14,0,0,0,0
1617,0,2,A,2,3,1663,1,2,28,29,1,10,33,16,14,27,13,17,-1,0,0,0,0
1617,2,1,H,3,0,1664,1,0,29,6,0,1,11,27,18,25,7,-16,23,0,0,0,0
1617,1,1,D,1,1,1665,1,0,7,19,2,4,22,31,26,11,-15,-9,-12,0,0,0,0
1617,2,0,H,2,1,1666,2,1,19,25,0,5,31,17,20,17,-3,14,-6,0,0,0,0
1617,3,0,H,2,1,1667,1,1,14,10,0,4,7,21,26,17,-9,-14,4,0,0,0,0
1617,0,0,D,3,2,1668,1,2,18,19,1,8,17,15,16,14,-2,2,-1,0,0,0,0
1617,1,0,H,2,3,1669,2,2,15,16,1,9,14,21,23,18,-5,-7,-1,0,0,0,0
1617,2,1,H,0,1,1670,0,1,6,8,1,5,12,27,29,12,-17,-15,-2,0,0,0,0
1617,1,2,A,2,2,1671,2,1,22,28,0,7,27,16,20,19,-1,11,-6,0,0,0,0
1617,1,3,A,1,2,1672,1,2,28,18,0,7,19,23,17,24,7,-4,10,0,0,0,0
1617,0,0,D,3,1,1673,2,1,16,10,0,4,7,24,22,14,-8,-17,6,0,0,0,0
1617,0,5,A,1,3,1674,0,2,20,28,1,11,27,15,32,23,-9,12,-8,0,0,0,0
1617,2,0,H,3,2,1675,1,2,21,20,1,8,17,15,21,22,1,2,1,0,0,0,0
1617,0,2,A,1,3,1676,0,1,6,19,2,10,14,16,29,11,-18,-2,-13,0,0,0,0
1617,1,3,A,1,4,1677,1,3,25,36,2,12,32,13,19,31,12,19,-11,0,0,0,1
1617,2,1,H,2,2,1678,2,1,23,17,2,6,20,26,16,22,6,-6,6,0,0,0,0
1617,1,0,H,3,3,1679,2,1,32,32,1,9,27,19,16,35,19,8,0,0,0,0,0
1617,1,0,H,2,2,1680,2,2,20,26,2,8,24,17,17,17,0,7,-6,0,0,0,0
1617,2,0,H,1,1,1681,1,0,11,20,1,4,23,37,24,7,-17,-14,-9,0,0,0,0
1617,1,0,H,4,3,1682,3,2,39,35,0,10,36,16,14,35,21,20,4,0,0,1,0
1617,0,0,D,3,1,1683,1,1,32,28,0,3,25,20,20,27,7,5,4,0,0,0,0
1617,2,1,H,3,2,1684,1,2,22,22,1,6,20,22,16,16,0,-2,0,0,0,0,0
1617,3,4,A,2,1,1685,2,0,23,6,2,5,11,31,17,18,1,-20,17,0,0,0,0
1617,3,1,H,2,2,1686,1,2,31,26,1,8,24,18,17,29,12,6,5,0,0,0,0
1617,5,3,H,3,1,1687,2,1,31,25,2,5,32,22,15,32,17,10,6,0,0,0,0
1617,0,3,A,1,3,1688,1,2,8,17,2,9,14,22,29,13,-16,-8,-9,0,0,0,0
1617,0,1,A,2,3,1689,1,1,17,24,0,10,24,21,28,21,-7,3,-7,0,0,0,0
1617,2,0,H,2,0,1690,2,0,21,9,1,1,14,30,24,22,-2,-16,12,0,0,0,0
1617,2,1,H,1,1,1691,1,1,29,14,0,4,9,24,20,25,5,-15,15,0,0,0,0
1617,3,0,H,3,2,1692,1,1,27,34,1,7,32,18,21,25,4,14,-7,0,0,0,0
1617,4,3,H,1,2,1693,0,1,20,17,1,6,21,29,39,23,-16,-8,3,0,0,0,0
1617,3,3,D,2,3,1694,2,2,26,34,2,11,37,18,21,25,4,19,-8,0,0,0,0
1617,1,1,D,1,1,1695,0,1,9,8,2,5,13,32,34,15,-19,-19,1,0,0,0,0
1617,3,1,H,3,3,1696,2,1,35,25,1,10,18,17,17,36,19,1,10,0,0,0,0
1617,0,0,D,2,2,1697,2,2,22,24,0,7,24,24,24,21,-3,0,-2,0,0,0,0
1617,1,0,H,1,2,1698,1,2,25,23,2,8,21,21,27,35,8,0,2,0,0,0,0
1617,1,0,H,1,1,1699,1,0,14,10,1,5,16,35,26,10,-16,-19,4,0,0,0,0
1617,2,1,H,3,2,1700,2,2,35,23,2,6,21,24,21,40,19,-3,12,0,0,0,0
1617,1,4,A,3,1,1701,1,1,25,32,1,3,27,21,20,19,-1,6,-7,0,0,0,0
1617,0,1,A,2,3,1702,2,2,23,38,2,10,39,18,22,21,-1,21,-15,0,0,0,0
1617,3,0,H,4,3,1703,3,2,42,20,0,9,17,22,14,36,22,-5,22,0,0,1,0
1617,1,0,H,2,0,1704,1,0,34,9,1,1,14,32,21,32,11,-18,25,0,0,0,0
1617,1,0,H,3,1,1705,1,0,33,23,0,4,27,42,20,27,7,-15,10,0,0,0,0
1617,0,0,D,2,1,1706,1,1,17,28,0,5,36,27,33,24,-9,9,-11,0,0,0,0
1617,1,2,A,2,3,1707,2,1,25,30,1,10,28,21,24,24,0,7,-5,0,0,0,0
1617,0,1,A,0,3,1708,0,2,9,20,4,9,17,25,33,14,-19,-8,-11,0,0,0,0
1617,3,1,H,3,3,1709,1,1,33,25,4,10,20,24,22,30,8,-4,8,0,0,0,0
1617,4,1,H,1,2,1710,0,2,23,23,4,8,21,23,43,27,-16,-2,0,0,0,0,0
1617,2,1,H,2,4,1711,2,3,27,45,5,12,39,14,24,28,4,25,-18,0,0,0,1
1617,2,1,H,2,1,1712,1,1,37,35,1,3,31,22,21,33,12,9,2,0,0,0,0
1617,3,1,H,3,1,1713,2,1,38,9,2,5,14,33,22,42,20,-19,29,0,0,0,0
1617,0,0,D,2,1,1714,2,1,23,17,0,4,11,26,26,22,-4,-15,6,0,0,0,0
1617,4,1,H,2,1,1715,1,0,18,10,0,5,16,36,33,24,-9,-20,8,0,0,0,0
1617,0,1,A,2,3,1716,2,2,25,41,4,10,40,18,26,25,-1,22,-16,0,0,0,0
1617,2,2,D,1,3,1717,1,1,29,36,5,9,28,20,27,36,9,8,-7,0,0,0,0
1617,0,3,A,3,2,1718,1,2,25,30,4,8,30,25,27,21,-6,5,-5,0,0,0,0
1617,1,2,A,3,3,1719,1,2,37,41,3,11,45,23,22,30,8,22,-4,0,0,0,0
1617,1,0,H,1,2,1720,1,2,35,24,3,6,22,26,24,32,8,-4,11,0,0,0,0
1617,2,0,H,3,1,1721,2,1,23,30,3,5,38,29,25,18,-7,9,-7,0,0,0,0
1617,1,0,H,1,2,1722,1,2,18,25,4,7,25,27,26,11,-15,-2,-7,0,0,0,0
1617,2,2,D,2,0,1723,2,0,23,9,2,1,14,34,27,22,-5,-20,14,0,0,0,0
1617,2,0,H,4,2,1724,3,1,45,40,0,7,35,22,16,40,24,13,5,0,0,1,0
1617,0,1,A,1,3,1725,0,1,10,36,2,10,33,23,40,17,-23,10,-26,0,0,0,0
1617,1,3,A,1,2,1726,1,1,9,21,2,6,28,34,36,15,-21,-6,-12,0,0,0,0
1617,1,0,H,3,1,1727,2,0,44,26,1,4,31,44,18,41,23,-13,18,0,0,0,0
1617,3,0,H,3,1,1728,1,1,39,9,1,5,16,39,23,34,11,-23,30,0,0,0,0
1617,0,1,A,2,3,1729,1,1,40,25,1,10,21,30,24,35,11,-9,15,0,0,0,0
1617,1,1,D,1,3,1730,0,2,26,26,4,9,20,25,45,31,-14,-5,0,0,0,0,0
1617,4,1,H,0,1,1731,0,1,10,21,4,4,12,26,36,16,-20,-14,-11,0,0,0,0
1617,3,3,D,2,2,1732,2,2,33,24,2,8,24,29,25,33,8,-5,9,0,0,0,0
1617,1,1,D,3,1,1733,2,0,44,10,2,5,17,41,24,47,23,-24,34,0,0,0,0
1617,3,2,H,2,3,1734,2,2,24,47,3,10,42,18,27,22,-5,24,-23,0,0,0,0
1617,0,2,A,2,4,1735,1,3,24,48,3,12,42,16,35,31,-4,26,-24,0,0,0,1
1617,1,1,D,1,1,1736,1,1,30,38,5,3,33,24,31,38,7,9,-8,0,0,0,0
1617,2,1,H,2,3,1737,2,1,25,37,1,9,31,24,28,25,-3,7,-12,0,0,0,0
1617,1,2,A,1,2,1738,1,2,9,34,2,8,36,28,42,16,-26,8,-25,0,0,0,0
1617,1,7,A,3,3,1739,2,2,27,45,3,11,48,25,26,21,-5,23,-18,0,0,0,0
1617,2,0,H,1,1,1740,1,0,39,27,3,4,32,46,25,34,9,-14,12,0,0,0,0
1617,0,0,D,3,2,1741,1,2,28,28,1,7,27,29,30,22,-8,-2,0,0,0,0,0
1617,1,1,D,1,1,1742,1,1,21,31,1,5,39,32,30,13,-17,7,-10,0,0,0,0
1617,0,1,A,2,2,1743,2,1,25,24,5,6,31,37,32,27,-5,-6,1,0,0,0,0
1617,1,0,H,4,3,1744,3,1,51,42,3,10,37,23,16,44,28,14,9,0,0,1,0
1617,0,1,A,3,2,1745,1,2,37,27,0,6,25,29,26,32,6,-4,10,0,0,0,0
1617,1,0,H,1,0,1746,0,0,11,13,2,1,20,37,42,18,-24,-17,-2,0,0,0,0
1617,2,6,A,1,2,1747,1,1,9,40,5,7,35,25,44,17,-27,10,-31,0,0,0,0
1617,4,0,H,3,2,1748,2,2,47,37,4,8,38,29,21,44,23,9,10,0,0,0,0
1617,0,1,A,3,3,1749,2,1,27,37,0,9,32,27,33,22,-11,5,-10,0,0,0,0
1617,0,2,A,0,4,1750,0,3,13,54,1,12,45,16,38,20,-18,29,-41,0,0,0,1
1617,2,0,H,3,2,1751,2,2,48,25,2,8,27,33,26,55,29,-6,23,0,0,0,0
1617,3,0,H,2,2,1752,2,2,37,29,2,7,27,29,33,38,5,-2,8,0,0,0,0
1617,0,2,A,1,4,1753,0,3,27,57,4,12,47,16,48,32,-16,31,-30,0,0,0,1
1617,0,2,A,0,3,1754,0,2,13,50,4,10,48,21,40,20,-20,27,-37,0,0,0,0
1617,2,0,H,3,1,1755,1,1,42,22,1,4,14,31,24,37,13,-17,20,0,0,0,0
1617,1,3,A,1,1,1756,0,1,14,42,2,3,36,25,42,19,-23,11,-28,0,0,0,0
1617,3,1,H,2,3,1757,2,2,30,27,3,9,22,34,29,26,-3,-12,3,0,0,0,0
1617,1,3,A,2,3,1758,1,1,27,29,3,10,22,30,37,32,-5,-8,-2,0,0,0,0
1617,5,3,H,1,1,1759,1,1,32,9,2,5,19,50,33,40,7,-31,23,0,0,0,0
1617,1,1,D,2,3,1760,1,1,43,40,4,9,33,27,27,41,14,6,3,0,0,0,0
1617,4,1,H,4,1,1761,3,0,60,14,0,5,20,45,16,49,33,-25,46,0,0,1,0
1617,1,0,H,1,0,1762,1,0,45,13,0,1,20,42,26,39,13,-22,32,0,0,0,0
1617,1,2,A,1,2,1763,1,1,22,44,1,7,42,28,33,14,-19,14,-22,0,0,0,0
1617,0,1,A,3,3,1764,2,1,27,45,0,10,39,24,37,23,-14,15,-18,0,0,0,0
1617,1,3,A,3,3,1765,1,2,32,51,1,11,57,26,31,25,-6,31,-19,0,0,0,0
1617,2,1,H,3,2,1766,1,2,41,40,0,8,41,33,28,34,6,8,1,0,0,0,0
1617,5,0,H,1,2,1767,1,2,9,25,2,8,27,35,55,22,-33,-8,-16,0,0,0,0
1617,4,1,H,3,1,1768,2,1,53,35,1,5,45,36,21,50,29,9,18,0,0,0,0
1617,1,1,D,2,1,1769,2,0,33,27,0,4,32,50,30,29,-1,-18,6,0,0,0,0
1617,1,2,A,2,2,1770,2,1,29,27,1,6,33,40,32,27,-5,-7,2,0,0,0,0
1617,2,0,H,4,1,1771,3,1,63,22,0,4,15,35,17,53,36,-20,41,0,0,1,0
1617,0,2,A,3,1,1772,2,1,54,48,2,3,40,26,27,60,33,14,6,0,0,0,0
1617,2,0,H,3,1,1773,1,1,32,12,1,5,27,55,34,26,-8,-28,20,0,0,0,0
1617,1,2,A,0,1,1774,0,0,13,28,1,4,33,51,43,20,-23,-18,-15,0,0,0,0
1617,1,1,D,2,3,1775,2,2,25,27,2,9,23,38,40,27,-13,-15,-2,0,0,0,0
1617,1,3,A,3,3,1776,1,2,48,56,1,10,54,22,24,40,16,32,-8,0,0,0,0
1617,1,0,H,2,2,1777,1,2,47,29,1,7,28,34,29,44,15,-6,18,0,0,0,0
1617,1,1,D,1,2,1778,0,2,14,34,2,6,30,31,49,21,-28,-1,-20,0,0,0,0
1617,0,1,A,2,3,1779,1,1,30,44,0,9,36,29,41,35,-6,7,-14,0,0,0,0
1617,2,2,D,2,1,1780,2,1,40,35,2,5,46,40,35,42,7,6,5,0,0,0,0
1617,3,1,H,3,3,1781,1,1,47,35,0,10,28,34,29,37,8,-6,12,0,0,0,0
1617,1,2,A,3,3,1782,2,2,59,54,1,11,60,29,23,57,34,31,5,0,0,0,0
1617,3,1,H,2,1,1783,2,1,35,12,0,5,27,57,32,31,-1,-30,23,0,0,0,0
1617,0,0,D,1,2,1784,1,2,51,41,0,8,44,37,26,42,16,7,10,0,0,0,0
1617,0,2,A,3,2,1785,2,1,28,50,0,7,45,29,39,24,-15,16,-22,0,0,0,0
1617,1,5,A,1,3,1786,0,1,31,48,1,10,41,27,52,35,-17,14,-17,0,0,0,0
1617,0,0,D,0,2,1787,0,1,13,30,1,6,35,42,45,21,-24,-7,-17,0,0,0,0
1617,0,2,A,1,2,1788,1,2,22,26,1,8,28,41,37,15,-22,-13,-4,0,0,0,0
1617,3,1,H,1,1,1789,1,0,36,15,2,5,22,50,42,48,6,-28,21,0,0,0,0
1617,1,1,D,2,4,1790,2,3,29,66,1,12,55,17,35,28,-7,38,-37,0,0,0,1
1617,2,1,H,4,3,1791,3,1,67,50,0,9,40,30,18,56,38,10,17,0,0,1,0
1617,0,1,A,2,2,1792,2,2,29,38,2,6,34,33,41,30,-11,1,-9,0,0,0,0
1617,4,0,H,3,1,1793,1,1,35,22,1,4,15,39,37,29,-8,-24,13,0,0,0,0
1617,1,0,H,2,1,1794,2,0,42,31,2,4,36,57,37,44,7,-21,11,0,0,0,0
1617,7,1,H,3,1,1795,1,1,51,52,1,3,42,26,28,46,18,16,-1,0,0,0,0
1617,3,0,H,3,0,1796,2,0,57,14,2,1,21,45,30,62,32,-24,43,0,0,0,0
1617,0,3,A,1,3,1797,0,2,15,59,2,10,58,25,53,23,-30,33,-44,0,0,0,0
1617,1,3,A,1,2,1798,1,2,12,30,2,7,29,36,60,28,-32,-7,-18,0,0,0,0
1617,0,1,A,2,3,1799,1,2,31,28,0,9,24,41,42,35,-7,-17,3,0,0,0,0
1617,3,1,H,2,1,1800,1,1,53,39,1,5,51,43,29,47,18,8,14,0,0,0,0
1617,1,0,H,3,2,1801,1,2,50,29,0,8,30,42,32,41,9,-12,21,0,0,0,0
1617,2,2,D,1,3,1802,1,1,39,54,2,10,53,29,46,52,6,24,-15,0,0,0,0
1617,3,0,H,1,1,1803,1,1,52,12,0,5,29,63,33,43,10,-34,40,0,0,0,0
1617,4,1,H,3,3,1804,2,1,31,38,0,10,33,37,41,25,-16,-4,-7,0,0,0,0
1617,0,0,D,1,2,1805,0,1,31,56,1,7,50,30,58,36,-22,20,-25,0,0,0,0
1617,0,1,A,0,2,1806,0,2,14,45,1,8,45,37,48,21,-27,8,-31,0,0,0,0
1617,2,3,A,1,3,1807,1,2,22,60,1,11,65,30,43,15,-28,35,-38,0,0,0,0
1617,3,1,H,3,2,1808,2,1,62,31,1,6,35,43,25,61,36,-8,31,0,0,0,0
1617,0,1,A,2,4,1809,2,3,41,70,0,12,58,19,33,35,2,39,-29,0,0,0,1
1617,4,1,H,2,1,1810,2,0,33,15,1,5,23,56,37,32,-5,-33,18,0,0,0,0
1617,2,0,H,3,1,1811,2,1,65,22,1,4,17,46,26,64,38,-29,43,0,0,0,0
1617,1,2,A,2,2,1812,1,1,31,57,0,7,50,30,46,36,-10,20,-26,0,0,0,0
1617,1,2,A,3,0,1813,1,0,38,14,1,1,21,49,41,34,-7,-28,24,0,0,0,0
1617,1,0,H,2,3,1814,2,2,48,34,2,9,29,42,37,46,9,-13,14,0,0,0,0
1617,0,5,A,2,1,1815,2,1,29,55,2,3,46,33,43,30,-13,13,-26,0,0,0,0
1617,1,1,D,3,4,1816,2,3,63,73,2,12,59,19,32,68,36,40,-10,0,0,0,1
1617,1,3,A,1,1,1817,0,0,15,32,2,4,36,58,60,24,-36,-22,-17,0,0,0,0
1617,1,1,D,1,3,1818,1,1,12,53,2,9,42,32,66,29,-37,10,-41,0,0,0,0
1617,2,2,D,1,2,1819,1,2,40,36,2,7,36,38,48,54,6,-2,4,0,0,0,0
1617,1,2,A,3,2,1820,1,2,55,41,1,6,35,34,31,55,24,1,14,0,0,0,0
1617,1,1,D,1,2,1821,1,1,58,31,0,6,37,48,33,51,18,-11,27,0,0,0,0
1617,1,1,D,1,1,1822,1,1,22,13,1,5,30,67,48,17,-31,-37,9,0,0,0,0
1617,2,0,H,4,3,1823,3,1,74,38,0,10,35,43,20,60,40,-8,36,0,0,1,0
1617,0,3,A,3,3,1824,2,2,34,68,0,10,66,26,43,29,-14,40,-34,0,0,0,0
1617,2,3,A,1,1,1825,0,1,35,41,1,5,56,50,59,39,-20,6,-6,0,0,0,0
1617,2,1,H,0,3,1826,0,1,17,55,1,10,56,33,50,23,-27,23,-38,0,0,0,0
1617,0,3,A,2,3,1827,1,2,60,64,1,11,69,33,31,52,21,36,-4,0,0,0,0
1617,4,0,H,3,1,1828,1,0,54,15,0,5,25,63,33,43,10,-38,39,0,0,0,0
1617,2,2,D,2,2,1829,2,2,44,51,0,8,47,37,35,37,2,10,-7,0,0,0,0
1617,3,0,H,2,2,1830,2,2,37,29,1,8,30,48,40,38,-2,-18,8,0,0,0,0
1617,4,0,H,1,3,1831,0,1,35,38,1,10,35,45,62,41,-21,-10,-3,0,0,0,0
1617,1,2,A,2,1,1832,2,1,52,23,2,4,18,49,39,49,10,-31,29,0,0,0,0
1617,2,2,D,2,2,1833,2,1,29,60,2,7,52,34,51,30,-21,18,-31,0,0,0,0
1617,2,2,D,3,3,1834,1,1,55,57,1,9,47,33,35,57,22,14,-2,0,0,0,0
1617,3,0,H,3,2,1835,2,2,67,40,2,7,41,40,33,72,39,1,27,0,0,0,0
1617,0,0,D,1,3,1836,0,2,15,34,2,9,29,46,67,25,-42,-17,-19,0,0,0,0
1617,0,2,A,1,4,1837,1,3,14,77,2,12,62,20,68,31,-37,42,-63,0,0,0,1
1617,1,1,D,3,1,1838,2,1,71,59,1,3,52,34,26,69,43,18,12,0,0,0,0
1617,2,1,H,2,2,1839,1,2,32,45,0,6,39,37,49,38,-11,2,-13,0,0,0,0
1617,1,1,D,1,0,1840,1,0,44,20,2,1,25,51,52,59,7,-26,24,0,0,0,0
1617,3,2,H,1,3,1841,1,2,60,35,0,9,29,46,35,53,18,-17,25,0,0,0,0
1617,5,4,H,2,3,1842,2,1,52,56,2,10,59,37,41,50,9,22,-4,0,0,0,0
1617,1,3,A,3,1,1843,1,1,38,45,1,5,60,53,49,35,-14,7,-7,0,0,0,0
1617,4,0,H,4,2,1844,3,2,80,30,0,8,32,53,20,64,44,-21,50,0,0,1,0
1617,6,2,H,2,1,1845,1,0,61,16,1,5,25,67,36,54,18,-42,45,0,0,0,0
1617,1,2,A,3,1,1846,1,1,58,26,0,4,20,50,35,49,14,-30,32,0,0,0,0
1617,1,2,A,2,0,1847,2,0,45,21,0,1,26,52,39,40,1,-26,24,0,0,0,0
1617,2,2,D,2,3,1848,1,2,35,70,0,11,75,33,50,40,-10,42,-35,0,0,0,0
1617,2,1,H,2,1,1849,2,0,40,38,1,4,45,62,43,41,-2,-17,2,0,0,0,0
1617,1,4,A,1,3,1850,1,2,14,72,2,10,70,27,70,31,-39,43,-58,0,0,0,0
1617,2,2,D,1,4,1851,1,3,63,83,0,12,68,20,37,56,19,48,-20,0,0,0,1
1617,1,1,D,1,2,1852,1,2,48,45,2,6,41,41,54,63,9,0,3,0,0,0,0
1617,4,0,H,3,2,1853,2,2,35,43,0,7,43,44,49,31,-18,-1,-8,0,0,0,0
1617,1,0,H,1,1,1854,0,1,38,14,1,5,32,74,64,46,-18,-42,24,0,0,0,0
1617,1,1,D,0,3,1855,0,1,24,58,1,9,50,37,53,28,-25,13,-34,0,0,0,0
1617,1,3,A,1,2,1856,1,1,29,36,1,6,42,52,51,22,-29,-10,-7,0,0,0,0
1617,1,2,A,2,3,1857,2,1,30,38,2,10,36,52,57,32,-25,-16,-8,0,0,0,0
1617,0,1,A,3,3,1858,1,2,56,71,1,11,77,35,42,63,21,42,-15,0,0,0,0
1617,2,0,H,1,2,1859,0,2,16,55,2,8,55,45,73,27,-46,10,-39,0,0,0,0
1617,1,3,A,3,2,1860,2,1,75,64,1,7,60,38,28,74,46,22,11,0,0,0,0
1617,1,1,D,4,1,1861,3,1,84,49,0,5,64,55,22,70,48,9,35,0,0,1,0
1617,3,1,H,3,1,1862,2,0,74,41,2,4,47,64,35,78,43,-17,33,0,0,0,0
1617,1,1,D,3,1,1863,1,0,41,19,1,5,29,73,53,38,-15,-44,22,0,0,0,0
1617,3,1,H,1,3,1864,1,2,29,38,1,9,35,49,54,23,-31,-14,-9,0,0,0,0
1617,1,0,H,2,3,1865,2,1,30,56,2,10,63,43,59,33,-26,20,-26,0,0,0,0
1617,7,3,H,2,2,1866,1,2,67,46,1,6,42,42,39,63,24,0,21,0,0,0,0
1617,1,4,A,3,3,1867,1,2,59,75,0,10,75,31,38,51,13,44,-16,0,0,0,0
1617,0,1,A,1,0,1868,1,0,14,25,2,1,29,54,75,32,-43,-25,-11,0,0,0,0
1617,2,2,D,2,2,1869,1,2,39,55,0,8,55,47,53,45,-8,8,-16,0,0,0,0
1617,1,1,D,2,1,1870,2,1,43,64,1,3,58,39,48,43,-5,19,-21,0,0,0,0
1617,1,1,D,1,3,1871,1,1,65,59,0,9,52,42,40,59,19,10,6,0,0,0,0
1617,3,2,H,2,2,1872,2,1,56,70,2,7,70,42,49,57,8,28,-14,0,0,0,0
1617,3,1,H,3,1,1873,2,1,38,14,0,5,32,76,52,36,-16,-44,24,0,0,0,0
1617,3,2,H,1,1,1874,0,1,41,32,1,4,26,55,67,48,-19,-29,9,0,0,0,0
1617,1,0,H,0,2,1875,0,2,28,44,1,7,44,49,54,30,-24,-5,-16,0,0,0,0
1617,1,2,A,3,2,1876,1,1,56,40,1,6,47,55,44,63,19,-8,16,0,0,0,0
1617,1,0,H,1,2,1877,0,2,20,33,2,8,34,59,74,30,-44,-25,-13,0,0,0,0
1617,3,1,H,3,4,1878,2,3,78,85,1,12,71,23,32,79,47,48,-7,0,0,0,1
1617,1,1,D,2,3,1879,2,1,46,42,0,10,39,54,49,45,-4,-15,4,0,0,0,0
1617,0,5,A,1,3,1880,1,2,50,77,2,11,81,36,56,65,9,45,-27,0,0,0,0
1617,3,5,A,3,3,1881,1,2,43,81,1,10,82,33,55,40,-15,49,-38,0,0,0,0
1617,4,1,H,3,2,1882,2,2,80,59,2,8,60,51,36,86,50,9,21,0,0,0,0
1617,0,1,A,1,1,1883,1,1,32,66,1,3,60,41,58,28,-30,19,-34,0,0,0,0
1617,2,1,H,2,1,1884,2,1,33,50,2,5,65,61,60,34,-26,4,-17,0,0,0,0
1617,3,0,H,4,0,1885,3,0,85,31,0,1,31,54,26,72,46,-23,54,0,0,1,0
1617,1,3,A,2,3,1886,1,1,70,56,1,10,64,46,45,72,27,18,14,0,0,0,0
1617,3,0,H,3,3,1887,1,2,60,41,0,9,39,53,43,53,10,-14,19,0,0,0,0
1617,6,2,H,2,1,1888,1,0,43,44,0,4,51,69,56,49,-7,-18,-1,0,0,0,0
1617,1,1,D,2,2,1889,2,2,44,47,1,6,46,50,50,44,-6,-4,-3,0,0,0,0
1617,2,0,H,1,1,1890,1,0,14,23,2,5,31,74,79,33,-46,-43,-9,0,0,0,0
1617,1,0,H,1,3,1891,1,1,69,43,0,10,43,60,41,61,20,-17,26,0,0,0,0
1617,1,2,A,3,4,1892,2,3,41,88,0,12,75,26,56,39,-17,49,-47,0,0,0,1
1617,2,1,H,1,3,1893,0,1,44,63,1,9,56,43,75,53,-22,13,-19,0,0,0,0
1617,3,1,H,0,2,1894,0,1,31,70,1,7,73,48,57,31,-26,25,-39,0,0,0,0
1617,2,2,D,2,1,1895,2,1,59,17,2,5,35,79,55,61,6,-44,42,0,0,0,0
1617,5,2,H,3,2,1896,1,2,59,45,1,7,45,51,47,67,20,-6,14,0,0,0,0
1617,2,1,H,1,1,1897,0,1,23,32,2,4,28,59,76,31,-45,-31,-9,0,0,0,0
1617,3,2,H,3,2,1898,2,2,84,36,1,8,36,61,36,87,51,-25,48,0,0,0,0
1617,2,4,A,2,3,1899,2,2,48,83,0,11,90,37,51,47,-4,53,-35,0,0,0,0
1617,5,3,H,1,2,1900,1,1,50,46,2,6,55,58,63,66,3,-3,4,0,0,0,0
1718,3,0,H,0,0,1901,0,0,0,0,0,0,0,0,0,0,0,0,0,0,0,0,0
1718,1,3,A,0,0,1902,0,0,0,0,0,0,0,0,0,0,0,0,0,0,0,0,0
1718,0,1,A,0,0,1903,0,0,0,0,0,0,0,0,0,0,0,0,0,0,0,0,0
1718,1,1,D,0,0,1904,0,0,0,0,0,0,0,0,0,0,0,0,0,0,0,0,0
1718,0,3,A,0,0,1905,0,0,0,0,0,0,0,0,0,0,0,0,0,0,0,0,0
1718,3,0,H,0,0,1906,0,0,0,0,0,0,0,0,0,0,0,0,0,0,0,0,0
1718,0,0,D,0,0,1907,0,0,0,0,0,0,0,0,0,0,0,0,0,0,0,0,0
1718,2,1,H,0,0,1908,0,0,0,0,0,0,0,0,0,0,0,0,0,0,0,0,0
1718,0,0,D,0,0,1909,0,0,0,0,0,0,0,0,0,0,0,0,0,0,0,0,0
1718,1,2,A,0,0,1910,0,0,0,0,0,0,0,0,0,0,0,0,0,0,0,0,0
1718,0,1,A,0,0,1911,0,0,0,1,0,1,1,1,2,1,-1,0,-1,0,0,0,0
1718,2,4,A,0,1,1912,0,1,1,3,1,3,3,0,0,0,0,3,-2,0,0,0,0
1718,1,3,A,1,1,1913,1,1,3,3,0,3,3,0,0,1,1,3,0,0,0,0,0
1718,1,2,A,1,0,1914,1,0,3,1,0,1,0,0,1,2,1,0,2,0,0,0,0
1718,0,0,D,0,0,1915,0,0,0,0,0,0,1,3,3,0,-3,-2,0,0,0,0,0
1718,1,2,A,0,1,1916,0,1,0,3,0,3,2,1,3,0,-3,1,-3,0,0,0,0
1718,2,1,H,1,0,1917,1,0,3,0,0,0,0,3,0,3,3,-3,3,0,0,0,0
1718,3,1,H,1,0,1918,1,0,3,0,0,0,0,1,1,3,2,-1,3,0,0,0,0
1718,3,2,H,0,0,1919,0,0,1,0,1,0,1,2,0,0,0,-1,1,0,0,0,0
1718,3,0,H,0,0,1920,0,0,1,1,1,1,0,0,1,1,0,0,0,0,0,0,0
1718,3,0,H,2,1,1921,2,1,6,3,0,3,3,3,2,7,5,0,3,0,0,0,0
1718,2,1,H,0,0,1922,0,0,0,1,0,1,0,3,4,1,-3,-3,-1,0,0,0,0
1718,0,1,A,0,1,1923,0,1,0,4,0,4,4,1,3,1,-2,3,-4,0,0,0,0
1718,0,3,A,1,2,1924,1,2,4,6,1,6,6,2,1,2,1,4,-2,0,0,0,0
1718,1,0,H,0,0,1925,0,0,0,1,0,1,0,3,5,1,-4,-3,-1,0,0,0,0
1718,2,0,H,2,1,1926,2,1,6,4,0,4,3,2,1,6,5,1,2,0,0,0,0
1718,4,1,H,1,2,1927,1,2,4,6,1,6,5,1,1,2,1,4,-2,0,0,0,0
1718,1,0,H,0,0,1928,0,0,0,1,0,1,2,4,5,3,-2,-2,-1,0,0,0,0
1718,0,5,A,0,0,1929,0,0,1,0,1,0,1,5,3,1,-2,-4,1,0,0,0,0
1718,0,2,A,0,3,1930,0,3,1,9,1,9,8,1,4,0,-4,7,-8,0,0,0,1
1718,2,1,H,1,1,1931,1,1,3,4,0,4,2,4,5,6,1,-2,-1,0,0,0,0
1718,3,0,H,1,0,1932,1,0,3,1,0,1,1,8,3,2,-1,-7,2,0,0,0,0
1718,1,1,D,1,1,1933,1,1,3,3,0,3,3,5,6,3,-3,-2,0,0,0,0,0
1718,2,3,A,0,2,1934,0,2,1,7,1,7,6,2,5,2,-3,4,-6,0,0,0,0
1718,2,1,H,2,1,1935,2,1,6,3,0,3,4,5,5,6,1,-1,3,0,0,0,0
1718,6,0,H,3,0,1936,3,0,9,0,0,0,1,4,2,9,7,-3,9,0,0,1,0
1718,1,3,A,0,3,1937,0,3,1,9,1,9,10,2,5,1,-4,8,-8,0,0,0,1
1718,0,2,A,1,1,1938,1,1,4,3,1,3,2,5,4,3,-1,-3,1,0,0,0,0
1718,2,2,D,2,2,1939,2,2,7,6,1,6,4,2,1,5,4,2,1,0,0,0,0
1718,1,1,D,1,4,1940,1,3,4,12,1,12,10,1,6,3,-3,9,-8,0,0,0,1
1718,5,1,H,1,0,1941,1,0,4,1,1,1,0,6,6,4,-2,-6,3,0,0,0,0
1718,0,4,A,0,2,1942,0,2,0,6,0,6,5,3,10,1,-9,2,-6,0,0,0,0
1718,0,1,A,2,0,1943,1,0,6,1,0,1,2,8,5,4,-1,-6,5,0,0,0,0
1718,1,1,D,0,1,1944,0,1,1,4,1,4,4,7,8,4,-4,-3,-3,0,0,0,0
1718,1,0,H,4,2,1945,3,1,12,6,0,6,8,6,3,13,10,2,6,0,0,1,0
1718,1,4,A,3,4,1946,2,3,10,12,1,12,15,2,4,9,5,13,-2,0,0,0,1
1718,2,0,H,3,1,1947,2,1,9,4,0,4,3,6,6,8,2,-3,5,0,0,0,0
1718,2,3,A,1,2,1948,1,2,3,8,0,8,7,3,7,5,-2,4,-5,0,0,0,0
1718,0,0,D,0,2,1949,0,2,1,7,1,7,6,4,11,1,-10,2,-6,0,0,0,0
1718,4,0,H,5,3,1950,3,2,15,11,0,11,10,5,3,14,11,5,4,1,0,1,0
1718,3,1,H,3,1,1951,2,1,9,3,0,3,7,10,3,9,6,-3,6,0,0,0,0
1718,2,3,A,1,5,1952,1,3,4,15,1,15,19,3,8,3,-5,16,-11,0,1,0,1
1718,0,2,A,2,1,1953,1,1,6,5,0,5,5,8,6,4,-2,-3,1,0,0,0,0
1718,2,0,H,0,0,1954,0,0,1,0,1,0,1,14,11,1,-10,-13,1,0,0,0,0
1718,1,1,D,2,2,1955,1,1,6,7,0,7,9,7,7,8,1,2,-1,0,0,0,0
1718,1,0,H,4,0,1956,3,0,13,2,1,2,5,9,2,11,9,-4,11,0,0,1,0
1718,2,0,H,2,4,1957,2,2,8,12,2,12,10,6,4,6,2,4,-4,0,0,0,0
1718,0,1,A,1,1,1958,0,1,4,5,1,5,4,7,8,3,-5,-3,-1,0,0,0,0
1718,0,3,A,0,3,1959,0,2,2,10,2,10,10,8,11,1,-10,2,-8,0,0,0,0
1718,0,1,A,0,1,1960,0,1,2,8,2,5,5,7,10,5,-5,-2,-6,0,0,0,0
1718,4,0,H,1,3,1961,1,2,3,11,0,11,8,4,13,8,-5,4,-8,0,0,0,0
1718,2,2,D,2,5,1962,1,3,8,18,1,15,18,3,8,10,2,15,-10,0,1,0,1
1718,1,2,A,0,4,1963,0,3,0,16,0,13,12,2,16,1,-15,10,-16,0,0,0,1
1718,2,1,H,1,2,1964,1,1,8,7,2,6,9,8,8,7,-1,1,1,0,0,0,0
1718,6,1,H,3,1,1965,2,0,13,4,1,4,3,9,8,13,5,-6,9,0,0,0,0
1718,0,2,A,4,4,1966,2,2,12,12,0,12,12,4,8,10,2,8,0,0,0,0,0
1718,3,0,H,5,2,1967,3,1,18,6,0,6,4,8,5,22,17,-4,12,1,0,1,0
1718,1,1,D,1,0,1968,1,0,4,4,1,1,3,11,11,5,-6,-8,0,0,0,0,0
1718,2,2,D,3,0,1969,2,0,11,2,2,2,1,14,9,10,1,-13,9,0,0,0,0
1718,1,2,A,5,3,1970,3,2,19,16,0,10,19,9,5,20,15,10,3,1,0,1,0
1718,0,1,A,4,5,1971,2,3,15,21,0,15,25,5,4,14,10,20,-6,0,1,0,1
1718,2,1,H,1,1,1972,1,1,11,5,2,4,6,12,7,6,-1,-6,6,0,0,0,0
1718,2,3,A,2,0,1973,1,0,6,2,0,2,5,11,11,4,-7,-6,4,0,0,0,0
1718,2,2,D,0,3,1974,0,2,5,12,1,11,12,11,12,4,-8,1,-7,0,0,0,0
1718,2,1,H,2,1,1975,1,1,7,6,0,3,12,13,10,10,0,-1,1,0,0,0,0
1718,3,2,H,4,4,1976,3,2,19,12,1,12,10,10,3,14,11,0,7,0,0,1,0
1718,3,1,H,3,2,1977,2,1,11,9,2,7,12,10,8,8,0,2,2,0,0,0,0
1718,0,0,D,1,1,1978,0,1,4,11,1,5,9,9,15,4,-11,0,-7,0,0,0,0
1718,1,0,H,0,0,1979,0,0,3,0,2,0,2,18,16,3,-13,-16,3,0,0,0,0
1718,0,0,D,5,4,1980,3,3,24,22,0,13,17,5,5,26,21,12,2,1,0,1,1
1718,5,0,H,3,0,1981,2,0,14,6,2,1,6,14,9,11,2,-8,8,0,0,0,0
1718,1,0,H,2,1,1982,1,1,9,14,1,5,8,8,13,13,0,0,-5,0,0,0,0
1718,0,3,A,0,2,1983,0,1,0,10,0,6,12,11,19,2,-17,1,-10,0,0,0,0
1718,3,2,H,1,0,1984,1,0,12,6,2,2,4,16,9,9,0,-12,6,0,0,0,0
1718,3,0,H,3,2,1985,2,1,19,6,1,6,6,14,10,21,11,-8,13,0,0,0,0
1718,0,0,D,4,0,1986,2,0,12,5,0,2,8,13,13,12,-1,-5,7,0,0,0,0
1718,0,1,A,1,1,1987,1,0,5,5,1,4,4,15,14,7,-7,-11,0,0,0,0,0
1718,0,1,A,3,4,1988,2,2,13,15,2,12,14,5,13,14,1,9,-2,0,0,0,0
1718,2,6,A,1,5,1989,1,3,6,19,0,15,21,7,15,13,-2,14,-13,0,1,0,1
1718,3,2,H,4,3,1990,3,2,23,17,1,11,16,9,5,17,12,7,6,0,0,1,0
1718,3,0,H,2,0,1991,1,0,12,6,1,2,6,19,13,14,1,-13,6,0,0,0,0
1718,1,2,A,1,3,1992,1,2,14,22,2,10,24,10,9,8,-1,14,-8,0,0,0,0
1718,2,1,H,2,0,1993,1,0,6,0,0,0,2,22,17,6,-11,-20,6,0,0,0,0
1718,1,4,A,1,4,1994,1,2,15,13,2,12,12,13,11,12,1,-1,2,0,0,0,0
1718,3,0,H,2,3,1995,1,2,13,13,0,11,14,14,11,15,4,0,0,0,0,0,0
1718,2,3,A,0,5,1996,0,3,6,25,2,15,26,5,13,8,-5,21,-19,0,1,0,1
1718,4,1,H,5,1,1997,3,1,22,5,0,4,7,15,9,27,18,-8,17,1,0,1,0
1718,1,0,H,4,0,1998,2,0,18,6,0,1,6,19,5,15,10,-13,12,0,0,0,0
1718,0,1,A,1,1,1999,0,1,8,6,1,3,15,21,15,5,-10,-6,2,0,0,0,0
1718,0,2,A,4,5,2000,2,3,16,25,0,15,31,10,14,16,2,21,-9,0,1,0,1
1718,1,0,H,4,1,2001,2,1,21,14,0,5,9,11,5,16,11,-2,7,0,0,0,0
1718,1,5,A,0,3,2002,0,2,0,25,0,10,26,11,24,3,-21,15,-25,0,0,0,0
1718,2,1,H,0,2,2003,0,1,6,16,1,6,18,11,20,6,-14,7,-10,0,0,0,0
1718,3,1,H,5,1,2004,3,0,28,8,0,4,5,16,7,29,22,-11,20,1,0,1,0
1718,4,1,H,3,1,2005,2,1,17,15,2,5,13,15,12,18,6,-2,2,0,0,0,0
1718,1,0,H,1,0,2006,1,0,5,6,1,2,10,16,19,8,-11,-6,-1,0,0,0,0
1718,2,1,H,3,2,2007,2,1,13,9,2,6,8,18,17,14,-3,-10,4,0,0,0,0
1718,2,1,H,1,2,2008,1,1,9,15,0,7,17,13,21,16,-5,4,-6,0,0,0,0
1718,1,2,A,0,4,2009,0,3,6,26,2,13,20,7,22,6,-16,13,-20,0,0,0,1
1718,2,3,A,1,0,2010,1,0,14,9,2,1,8,21,12,9,-3,-13,5,0,0,0,0
1718,0,2,A,0,3,2011,0,2,6,20,2,11,22,13,17,10,-7,9,-14,0,0,0,0
1718,1,1,D,2,1,2012,1,1,15,8,1,4,9,19,15,18,3,-10,7,0,0,0,0
1718,2,1,H,2,0,2013,1,0,9,6,0,2,7,24,20,9,-11,-17,3,0,0,0,0
1718,0,0,D,1,5,2014,1,3,15,31,2,15,32,8,19,14,-5,24,-16,0,1,0,1
1718,2,4,A,2,4,2015,1,2,16,24,0,12,17,5,13,19,6,12,-8,0,0,0,0
1718,1,1,D,4,3,2016,3,2,29,16,1,11,16,18,8,22,14,-2,13,0,0,1,0
1718,2,1,H,5,0,2017,3,0,28,0,0,0,4,29,10,33,23,-25,28,1,0,1,0
1718,0,2,A,1,4,2018,0,2,8,16,1,12,16,16,19,6,-13,0,-8,0,0,0,0
1718,2,1,H,5,4,2019,3,2,32,19,0,12,18,16,8,32,24,2,13,1,0,1,0
1718,2,1,H,4,3,2020,2,2,27,28,0,10,31,12,7,21,14,19,-1,0,0,0,0
1718,1,2,A,0,1,2021,0,0,0,8,0,4,6,21,31,5,-26,-15,-8,0,0,0,0
1718,0,1,A,0,0,2022,0,0,12,6,1,2,10,19,23,11,-12,-9,6,0,0,0,0
1718,2,0,H,4,2,2023,3,1,30,16,1,7,19,16,9,23,14,3,14,0,0,1,0
1718,3,2,H,3,5,2024,2,3,23,31,2,15,35,11,13,24,11,24,-8,0,1,0,1
1718,1,1,D,1,2,2025,1,1,9,16,1,6,21,17,20,10,-10,4,-7,0,0,0,0
1718,1,1,D,3,1,2026,2,1,17,16,2,5,14,19,19,17,-2,-5,1,0,0,0,0
1718,0,1,A,1,2,2027,1,1,12,12,0,6,11,21,22,18,-4,-10,0,0,0,0,0
1718,2,3,A,0,1,2028,0,1,6,14,2,5,11,15,26,8,-18,-4,-8,0,0,0,0
1718,3,0,H,1,3,2029,1,2,17,26,2,11,27,15,17,14,-3,12,-9,0,0,0,0
1718,1,3,A,2,4,2030,1,3,15,33,0,13,25,9,21,12,-9,16,-18,0,0,0,1
1718,2,1,H,1,1,2031,1,1,17,10,2,4,11,21,20,15,-5,-10,7,0,0,0,0
1718,0,2,A,1,0,2032,0,0,11,6,1,2,10,29,22,8,-14,-19,5,0,0,0,0
1718,1,1,D,0,4,2033,0,2,9,30,2,12,23,8,19,11,-8,15,-21,0,0,0,0
1718,3,0,H,5,0,2034,3,0,31,12,0,1,11,24,14,37,23,-13,19,1,0,1,0
1718,1,1,D,3,2,2035,2,1,28,17,1,6,22,18,14,32,18,4,11,0,0,0,0
1718,0,0,D,4,3,2036,2,2,19,18,0,11,18,20,18,19,1,-2,1,0,0,0,0
1718,0,1,A,1,5,2037,1,3,12,35,0,15,34,9,23,18,-5,25,-23,0,1,0,1
1718,1,0,H,2,0,2038,1,0,16,0,1,0,6,33,18,19,1,-27,16,0,0,0,0
1718,0,1,A,5,5,2039,3,3,38,34,0,15,40,14,9,35,26,26,4,1,1,1,1
1718,3,1,H,4,1,2040,2,1,31,10,0,4,12,23,9,24,15,-11,21,0,0,0,0
1718,1,1,D,3,2,2041,2,1,19,19,2,7,20,18,20,18,-2,2,0,0,0,0,0
1718,2,2,D,0,4,2042,0,2,0,20,0,12,19,18,34,6,-28,1,-20,0,0,0,0
1718,1,1,D,1,2,2043,1,1,20,15,2,6,13,24,17,17,0,-11,5,0,0,0,0
1718,3,0,H,2,1,2044,1,0,18,11,0,4,8,24,19,23,4,-16,7,0,0,0,0
1718,5,0,H,4,1,2045,3,1,36,20,1,5,17,21,10,28,18,-4,16,0,0,1,0
1718,1,2,A,3,3,2046,2,2,26,29,2,10,33,15,18,27,9,18,-3,0,0,0,0
1718,0,3,A,0,1,2047,0,1,12,12,1,3,18,24,27,11,-16,-6,0,0,0,0,0
1718,0,1,A,0,0,2048,0,0,9,10,2,2,12,20,29,12,-17,-8,-1,0,0,0,0
1718,2,2,D,2,3,2049,1,2,16,26,0,11,28,20,25,14,-11,8,-10,0,0,0,0
1718,0,0,D,5,4,2050,3,3,37,39,0,13,33,10,14,41,27,23,-2,1,0,1,1
1718,0,0,D,1,4,2051,1,2,20,34,2,12,27,10,26,17,-9,17,-14,0,0,0,0
1718,2,1,H,4,1,2052,2,1,21,21,0,5,18,18,20,21,1,0,0,0,0,0,0
1718,0,0,D,5,2,2053,3,1,38,21,0,6,26,19,10,35,25,7,17,1,0,1,0
1718,2,1,H,1,0,2054,0,0,11,12,1,1,11,30,27,8,-19,-19,-1,0,0,0,0
1718,2,2,D,1,0,2055,1,0,10,9,1,2,12,30,26,13,-13,-18,1,0,0,0,0
1718,2,0,H,1,0,2056,1,0,15,1,0,0,8,36,24,21,-3,-28,14,0,0,0,0
1718,1,3,A,3,3,2057,2,2,32,20,1,11,19,21,16,35,19,-2,12,0,0,0,0
1718,1,2,A,0,2,2058,0,1,13,20,2,7,21,19,20,13,-7,2,-7,0,0,0,0
1718,1,3,A,4,1,2059,3,1,40,18,1,3,23,24,10,33,23,-1,22,0,0,1,0
1718,1,0,H,4,2,2060,2,1,35,17,0,6,16,27,10,27,17,-11,18,0,0,0,0
1718,1,3,A,3,5,2061,2,3,23,39,2,15,35,10,22,22,0,25,-16,0,1,0,1
1718,3,3,D,2,3,2062,1,2,23,32,1,10,36,19,20,23,3,17,-9,0,0,0,0
1718,1,2,A,0,1,2063,0,1,1,11,0,4,15,28,38,8,-30,-13,-10,0,0,0,0
1718,0,3,A,1,5,2064,1,3,21,38,2,15,41,14,20,19,-1,27,-17,0,1,0,1
1718,1,0,H,0,1,2065,0,1,12,21,1,5,17,26,32,12,-20,-9,-9,0,0,0,0
1718,0,0,D,2,0,2066,1,0,22,13,0,2,14,22,19,26,7,-8,9,0,0,0,0
1718,0,1,A,3,1,2067,2,0,27,14,2,4,10,28,22,30,8,-18,13,0,0,0,0
1718,3,0,H,0,4,2068,0,2,10,24,2,12,23,21,32,14,-18,2,-14,0,0,0,0
1718,0,1,A,2,2,2069,1,1,17,23,0,6,26,19,28,16,-12,7,-6,0,0,0,0
1718,2,3,A,1,1,2070,1,1,21,21,2,5,19,23,27,17,-10,-4,0,0,0,0,0
1718,1,0,H,0,0,2071,0,0,14,1,2,0,9,40,22,14,-8,-31,13,0,0,0,0
1718,1,0,H,5,4,2072,3,2,41,38,0,12,28,10,14,44,30,18,3,1,0,1,0
1718,4,0,H,3,0,2073,2,0,33,15,1,1,13,32,22,39,17,-19,18,0,0,0,0
1718,0,2,A,4,2,2074,2,1,24,24,0,7,26,23,24,23,-1,3,0,0,0,0,0
1718,3,2,H,5,3,2075,3,2,42,27,0,11,30,23,11,38,27,7,15,1,0,1,0
1718,1,0,H,1,4,2076,0,3,17,40,1,13,34,13,28,11,-17,21,-23,0,0,0,1
1718,2,2,D,1,3,2077,1,2,14,23,1,11,23,25,29,17,-12,-2,-9,0,0,0,0
1718,4,0,H,1,0,2078,1,0,21,13,0,2,17,32,25,26,1,-15,8,0,0,0,0
1718,0,1,A,0,5,2079,0,3,15,45,1,15,41,13,36,13,-23,28,-30,0,1,0,1
1718,1,2,A,2,2,2080,1,1,27,17,1,6,16,29,23,28,5,-13,10,0,0,0,0
1718,1,0,H,0,1,2081,0,1,1,21,0,5,19,30,41,9,-32,-11,-20,0,0,0,0
1718,1,2,A,1,1,2082,1,1,24,24,2,3,30,25,25,22,-3,5,0,0,0,0,0
1718,1,1,D,2,4,2083,1,2,26,24,0,12,23,26,19,27,8,-3,2,0,0,0,0
1718,0,0,D,4,3,2084,3,2,40,36,1,10,43,22,14,34,20,21,4,0,0,1,0
1718,1,1,D,4,1,2085,2,0,38,20,0,4,12,28,11,28,17,-16,18,0,0,0,0
1718,2,0,H,3,1,2086,2,1,27,15,2,4,19,31,26,32,6,-12,12,0,0,0,0
1718,0,0,D,3,0,2087,2,0,24,17,2,2,15,22,27,25,-2,-7,7,0,0,0,0
1718,1,3,A,0,5,2088,0,3,13,44,2,15,45,14,36,17,-19,31,-31,0,1,0,1
1718,1,1,D,1,1,2089,1,1,21,27,2,3,32,26,31,19,-12,6,-6,0,0,0,0
1718,1,1,D,2,4,2090,1,3,27,41,3,13,34,14,20,28,8,20,-14,0,0,0,1
1718,3,2,H,0,3,2091,0,2,4,30,3,11,34,26,41,10,-31,8,-26,0,0,0,0
1718,0,1,A,2,5,2092,1,3,20,47,3,15,48,15,30,18,-12,33,-27,0,1,0,1
1718,1,0,H,0,1,2093,0,0,18,21,2,4,13,29,22,15,-7,-16,-3,0,0,0,0
1718,1,0,H,4,0,2094,2,0,25,15,0,1,13,37,27,24,-3,-24,10,0,0,0,0
1718,2,0,H,5,0,2095,3,0,48,13,0,2,18,39,13,42,29,-21,35,1,0,1,0
1718,1,2,A,4,2,2096,2,1,39,27,0,7,29,25,12,29,17,4,12,0,0,0,0
1718,2,5,A,1,3,2097,1,2,15,37,1,10,43,22,33,19,-14,21,-22,0,0,0,0
1718,3,0,H,3,1,2098,2,1,25,24,2,5,23,27,27,25,-2,-4,1,0,0,0,0
1718,0,1,A,2,5,2099,1,3,30,51,4,15,44,13,26,31,5,31,-21,0,1,0,1
1718,3,0,H,1,0,2100,1,0,24,7,2,0,13,43,30,23,-7,-30,17,0,0,0,0
1718,1,2,A,2,4,2101,1,2,20,28,3,12,25,27,31,18,-13,-2,-8,0,0,0,0
1718,1,1,D,4,4,2102,3,2,42,39,1,12,30,14,15,35,20,16,3,0,0,1,0
1718,5,1,H,3,1,2103,2,1,40,22,1,5,20,32,24,48,24,-12,18,0,0,0,0
1718,3,1,H,3,2,2104,2,1,30,28,2,6,29,21,29,36,7,8,2,0,0,0,0
1718,1,1,D,1,3,2105,0,2,21,28,4,11,28,27,30,13,-17,1,-7,0,0,0,0
1718,1,1,D,1,1,2106,1,1,28,15,3,4,21,38,27,33,6,-17,13,0,0,0,0
1718,0,3,A,0,0,2107,0,0,13,15,2,1,13,38,41,18,-23,-25,-2,0,0,0,0
1718,1,0,H,5,0,2108,3,0,50,21,0,2,16,22,15,49,34,-6,29,1,0,1,0
1718,3,0,H,3,1,2109,2,1,43,29,1,3,34,28,25,53,28,6,14,0,0,0,0
1718,1,1,D,3,4,2110,2,2,33,40,2,12,31,15,30,39,9,16,-7,0,0,0,0
1718,0,2,A,1,5,2111,1,3,22,53,5,15,50,15,37,21,-16,35,-31,0,1,0,1
1718,0,3,A,1,2,2112,0,1,22,30,4,7,31,27,31,14,-17,4,-8,0,0,0,0
1718,1,1,D,0,2,2113,0,1,18,20,4,6,19,33,38,16,-22,-14,-2,0,0,0,0
1718,1,4,A,2,0,2114,1,0,28,13,0,2,18,44,24,30,6,-26,15,0,0,0,0
1718,0,1,A,0,1,2115,0,1,21,29,5,3,34,31,23,16,-7,3,-8,0,0,0,0
1718,2,1,H,4,3,2116,2,2,31,46,3,10,56,25,28,27,-1,31,-15,0,0,0,0
1718,3,1,H,5,1,2117,3,1,54,27,0,5,26,30,13,45,32,-4,27,1,0,1,0
1718,0,1,A,4,3,2118,2,2,41,34,0,11,40,31,16,32,16,9,7,0,0,0,0
1718,1,1,D,1,4,2119,1,3,16,43,4,13,36,16,39,22,-17,20,-27,0,0,0,1
1718,3,0,H,3,0,2120,2,0,29,7,2,0,13,46,28,29,1,-33,22,0,0,0,0
1718,1,1,D,4,0,2121,3,0,44,19,1,1,17,39,17,37,20,-22,25,0,0,1,0
1718,1,1,D,3,3,2122,2,2,37,32,2,11,32,28,31,41,10,4,5,0,0,0,0
1718,1,0,H,2,1,2123,1,1,33,22,1,5,21,39,27,34,7,-18,11,0,0,0,0
1718,0,2,A,0,5,2124,0,3,7,57,3,15,48,14,49,13,-36,34,-50,0,1,0,1
1718,1,2,A,1,2,2125,1,1,27,28,5,6,31,28,33,27,-6,3,-1,0,0,0,0
1718,2,0,H,2,1,2126,1,1,21,17,0,4,23,40,34,20,-14,-17,4,0,0,0,0
1718,7,0,H,5,1,2127,3,0,56,22,0,4,14,34,15,52,37,-20,34,1,0,1,0
1718,1,1,D,1,4,2128,1,2,32,34,3,12,29,29,31,35,4,0,-2,0,0,0,0
1718,0,1,A,0,4,2129,0,2,16,41,5,12,32,17,45,22,-23,15,-25,0,0,0,0
1718,1,2,A,3,0,2130,2,0,46,21,1,2,16,24,27,57,30,-8,25,0,0,0,0
1718,0,2,A,2,5,2131,1,3,31,59,3,15,59,15,29,33,4,44,-28,0,1,0,1
1718,1,1,D,0,2,2132,0,1,20,36,4,7,35,27,40,18,-22,8,-16,0,0,0,0
1718,4,1,H,5,3,2133,3,2,60,46,0,10,58,29,14,50,36,29,14,1,0,1,0
1718,0,4,A,1,4,2134,1,2,17,35,4,12,30,30,42,23,-19,0,-18,0,0,0,0
1718,0,1,A,1,0,2135,1,0,22,24,2,2,18,25,40,21,-19,-7,-2,0,0,0,0
1718,2,1,H,4,1,2136,3,1,45,27,1,5,28,35,18,38,20,-7,18,0,0,1,0
1718,5,2,H,4,0,2137,2,0,44,7,0,0,13,51,17,33,16,-38,37,0,0,0,0
1718,2,0,H,3,0,2138,2,0,38,16,2,2,22,46,32,42,10,-24,22,0,0,0,0
1718,0,0,D,1,2,2139,0,1,22,24,1,6,22,34,41,14,-27,-12,-2,0,0,0,0
1718,2,0,H,3,1,2140,2,1,33,33,2,3,36,32,29,33,4,4,0,0,0,0,0
1718,2,1,H,1,2,2141,1,1,22,25,2,6,22,34,41,21,-20,-12,-3,0,0,0,0
1718,2,0,H,0,4,2142,0,3,27,48,2,13,40,19,25,19,-6,21,-21,0,0,0,1
1718,0,2,A,1,4,2143,1,2,33,47,0,12,38,19,34,36,2,19,-14,0,0,0,0
1718,1,1,D,2,2,2144,1,1,37,31,1,6,33,31,28,36,8,2,6,0,0,0,0
1718,3,2,H,0,0,2145,0,0,7,21,0,1,19,41,56,15,-41,-22,-14,0,0,0,0
1718,2,1,H,1,1,2146,1,0,27,23,2,4,14,41,37,29,-8,-27,4,0,0,0,0
1718,1,0,H,4,3,2147,2,2,38,41,0,11,44,32,30,34,4,12,-3,0,0,0,0
1718,1,0,H,5,1,2148,3,1,63,17,0,4,23,46,15,54,39,-23,46,1,0,1,0
1718,0,1,A,3,5,2149,2,3,36,62,2,15,61,15,29,35,6,46,-26,0,1,0,1
1718,2,0,H,3,0,2150,2,0,46,16,1,2,22,48,33,59,26,-26,30,0,0,0,0
1718,2,0,H,1,0,2151,1,0,30,30,2,2,21,25,38,31,-7,-4,0,0,0,0,0
1718,2,0,H,4,0,2152,3,0,48,10,1,0,18,58,21,40,19,-40,38,0,0,1,0
1718,2,3,A,0,1,2153,0,1,21,17,1,4,23,47,44,21,-23,-24,4,0,0,0,0
1718,1,0,H,2,1,2154,1,1,32,25,0,5,23,42,32,34,2,-19,7,0,0,0,0
1718,0,2,A,4,4,2155,2,2,50,41,0,12,35,30,19,40,21,5,9,0,0,0,0
1718,2,1,H,3,1,2156,2,1,41,33,2,3,36,36,33,44,11,0,8,0,0,0,0
1718,0,3,A,1,3,2157,0,2,23,49,1,10,61,33,43,15,-28,28,-26,0,0,0,0
1718,2,1,H,0,3,2158,0,2,16,36,2,11,35,30,50,22,-28,5,-20,0,0,0,0
1718,0,5,A,2,5,2159,1,3,25,66,0,15,55,15,36,23,-13,40,-41,0,1,0,1
1718,0,1,A,3,5,2160,2,3,52,65,1,15,62,15,33,64,31,47,-13,0,1,0,1
1718,2,4,A,5,4,2161,3,2,69,50,0,12,40,21,15,60,45,19,19,1,0,1,0
1718,1,0,H,1,1,2162,1,1,20,33,1,5,33,38,49,26,-23,-5,-13,0,0,0,0
1718,3,0,H,4,3,2163,2,2,53,36,0,11,36,32,23,44,21,4,17,0,0,0,0
1718,1,0,H,0,1,2164,0,1,19,25,2,5,23,43,51,24,-27,-20,-6,0,0,0,0
1718,0,1,A,1,2,2165,1,1,33,38,2,7,37,29,39,33,-6,8,-5,0,0,0,0
1718,2,2,D,2,3,2166,1,2,25,52,0,10,64,34,41,23,-18,30,-27,0,0,0,0
1718,4,1,H,0,3,2167,0,2,21,44,1,11,46,34,47,23,-24,12,-23,0,0,0,0
1718,1,0,H,2,0,2168,1,0,35,10,0,0,18,60,32,35,3,-42,25,0,0,0,0
1718,0,1,A,0,4,2169,0,2,30,44,2,12,37,30,27,21,-6,7,-14,0,0,0,0
1718,0,0,D,4,5,2170,3,3,51,69,1,15,62,19,21,42,21,43,-18,0,1,1,1
1718,2,0,H,5,1,2171,3,1,68,33,0,3,37,38,15,63,48,-1,35,1,0,1,0
1718,1,1,D,1,1,2172,0,1,23,23,1,4,27,49,46,15,-31,-22,0,0,0,0,0
1718,2,0,H,5,2,2173,3,1,71,41,0,7,38,29,15,65,50,9,30,1,0,1,0
1718,0,0,D,1,5,2174,1,3,24,74,1,15,67,15,50,28,-22,52,-50,0,1,0,1
1718,1,2,A,1,1,2175,1,0,33,24,0,4,16,47,40,37,-3,-31,9,0,0,0,0
1718,1,2,A,0,2,2176,0,1,10,26,0,6,25,43,61,18,-43,-18,-16,0,0,0,0
1718,0,2,A,0,4,2177,0,2,24,56,1,12,47,23,48,27,-21,24,-32,0,0,0,0
1718,1,1,D,3,1,2178,2,1,53,33,1,5,33,40,36,66,30,-7,20,0,0,0,0
1718,3,2,H,4,1,2179,2,1,47,25,0,5,23,44,30,38,8,-21,22,0,0,0,0
1718,1,0,H,5,0,2180,3,0,70,30,0,2,21,28,19,62,43,-7,40,1,0,1,0
1718,0,5,A,3,4,2181,2,3,44,52,2,13,42,21,38,47,9,21,-8,0,0,0,1
1718,1,2,A,3,2,2182,2,1,36,38,2,6,36,32,35,36,1,4,-2,0,0,0,0
1718,0,5,A,0,2,2183,0,1,22,41,2,7,38,31,51,25,-26,7,-19,0,0,0,0
1718,2,0,H,2,1,2184,1,1,44,33,1,3,38,42,31,43,12,-4,11,0,0,0,0
1718,1,1,D,1,4,2185,1,2,34,59,2,12,49,23,41,34,-7,26,-25,0,0,0,0
1718,0,4,A,2,3,2186,1,2,29,36,0,11,37,37,44,27,-17,0,-7,0,0,0,0
1718,2,1,H,1,3,2187,1,2,25,44,2,11,47,43,47,25,-22,4,-19,0,0,0,0
1718,2,0,H,2,0,2188,1,0,41,24,0,1,27,50,33,38,5,-23,17,0,0,0,0
1718,1,1,D,0,1,2189,0,1,30,25,2,4,28,50,29,21,-8,-22,5,0,0,0,0
1718,3,0,H,4,0,2190,3,0,55,22,1,2,25,56,21,47,26,-31,33,0,0,1,0
1718,3,1,H,5,4,2191,3,2,75,50,0,12,41,32,15,67,52,9,25,1,0,1,0
1718,6,2,H,3,0,2192,2,0,54,10,1,0,19,63,37,67,30,-44,44,0,0,0,0
1718,1,1,D,1,5,2193,0,3,27,73,1,15,63,19,48,18,-30,44,-46,0,1,0,1
1718,1,2,A,2,3,2194,1,2,47,44,1,11,48,45,31,45,14,3,3,0,0,0,0
1718,2,1,H,0,2,2195,0,1,31,29,2,6,27,48,30,22,-8,-21,2,0,0,0,0
1718,0,2,A,1,2,2196,1,1,33,44,0,6,40,33,44,38,-6,7,-11,0,0,0,0
1718,3,0,H,0,0,2197,0,0,10,22,0,2,25,59,69,21,-48,-34,-12,0,0,0,0
1718,1,1,D,1,1,2198,1,0,28,28,2,4,19,49,48,27,-21,-30,0,0,0,0,0
1718,0,0,D,4,4,2199,2,3,50,58,0,13,50,21,35,42,7,29,-8,0,0,0,1
1718,4,1,H,3,0,2200,2,0,39,24,2,1,27,52,37,41,4,-25,15,0,0,0,0
1718,2,4,A,0,5,2201,0,3,13,78,0,15,70,16,69,24,-45,54,-65,0,1,0,1
1718,0,2,A,4,2,2202,2,1,60,47,0,6,42,33,24,50,26,9,13,0,0,0,0
1718,0,0,D,3,0,2203,2,0,47,34,2,2,24,31,46,50,4,-7,13,0,0,0,0
1718,1,1,D,1,2,2204,1,1,26,47,1,7,46,33,51,29,-22,13,-21,0,0,0,0
1718,1,0,H,0,1,2205,0,1,24,35,1,5,35,42,56,28,-28,-7,-11,0,0,0,0
1718,1,1,D,4,1,2206,2,0,51,29,0,4,20,50,35,42,7,-30,22,0,0,0,0
1718,2,1,H,5,1,2207,3,1,74,29,0,5,28,49,20,64,44,-21,45,1,0,1,0
1718,1,0,H,3,4,2208,2,3,42,59,2,13,50,21,38,45,7,29,-17,0,0,0,1
1718,1,2,A,1,3,2209,1,2,33,57,0,10,73,39,46,38,-8,34,-24,0,0,0,0
1718,1,0,H,0,2,2210,0,1,22,29,2,6,28,50,62,25,-37,-22,-7,0,0,0,0
1718,0,0,D,2,4,2211,1,3,48,59,1,13,50,22,34,47,13,28,-11,0,0,0,1
1718,2,1,H,2,1,2212,1,1,29,33,0,3,39,48,51,28,-23,-9,-4,0,0,0,0
1718,0,0,D,1,3,2213,1,2,29,45,2,11,46,38,51,29,-22,8,-16,0,0,0,0
1718,1,0,H,0,0,2214,0,0,35,27,2,1,29,56,31,24,-7,-27,8,0,0,0,0
1718,2,0,H,1,0,2215,1,0,35,25,2,2,26,62,43,35,-8,-36,10,0,0,0,0
1718,0,0,D,2,1,2216,1,1,50,27,0,4,30,52,33,44,11,-22,23,0,0,0,0
1718,3,0,H,5,3,2217,3,2,81,48,0,11,50,46,18,74,56,4,33,1,0,1,0
1718,0,0,D,3,4,2218,2,2,60,60,1,12,50,26,40,75,35,24,0,0,0,0,0
1718,0,0,D,4,5,2219,2,3,52,77,0,15,66,21,36,43,7,45,-25,0,1,0,1
1718,2,2,D,1,0,2220,0,0,30,13,1,0,26,73,51,21,-30,-47,17,0,0,0,0
1718,4,0,H,4,2,2221,3,1,60,32,1,6,30,52,22,50,28,-22,28,0,0,1,0
1718,0,3,A,0,2,2222,0,1,14,49,0,7,47,34,75,28,-47,13,-35,0,0,0,0
1718,1,1,D,0,5,2223,0,3,27,84,1,15,77,18,57,29,-28,59,-57,0,1,0,1
1718,3,4,A,2,3,2224,1,2,51,61,0,10,75,40,33,44,11,35,-10,0,0,0,0
1718,4,2,H,5,1,2225,3,1,78,33,0,3,40,50,21,66,45,-10,45,1,0,1,0
1718,2,1,H,4,0,2226,2,0,61,38,0,2,25,31,26,50,24,-6,23,0,0,0,0
1718,1,0,H,3,1,2227,2,1,48,38,2,5,37,43,49,50,1,-6,10,0,0,0,0
1718,0,0,D,1,1,2228,1,1,28,30,1,5,29,51,52,30,-22,-22,-2,0,0,0,0
1718,1,1,D,3,4,2229,2,2,46,53,2,12,43,36,38,46,8,7,-7,0,0,0,0
1718,0,1,A,0,1,2230,0,0,25,31,2,4,23,53,64,26,-38,-30,-6,0,0,0,0
1718,0,1,A,4,0,2231,2,0,54,14,0,0,28,78,37,44,7,-50,40,0,0,0,0
1718,1,0,H,1,2,2232,0,1,34,51,1,6,47,37,53,24,-29,10,-17,0,0,0,0
1718,0,3,A,1,4,2233,1,2,29,64,1,12,52,27,52,30,-22,25,-35,0,0,0,0
1718,2,1,H,2,3,2234,1,2,52,47,1,11,47,39,34,50,16,8,5,0,0,0,0
1718,0,0,D,2,1,2235,1,1,32,38,0,5,37,44,56,30,-26,-7,-6,0,0,0,0
1718,1,2,A,1,4,2236,1,3,31,63,2,13,54,22,51,29,-22,32,-32,0,0,0,1
1718,0,1,A,5,5,2237,3,3,85,81,0,15,70,23,19,78,59,47,4,1,1,1,1
1718,4,0,H,3,3,2238,2,2,64,51,1,11,51,49,43,79,36,2,13,0,0,0,0
1718,1,2,A,1,0,2239,1,0,33,28,0,1,30,58,54,42,-12,-28,5,0,0,0,0
1718,3,1,H,0,0,2240,0,0,38,25,2,2,26,65,33,26,-7,-39,13,0,0,0,0
1718,2,3,A,4,5,2241,3,3,66,85,1,15,78,20,23,56,33,58,-19,0,1,1,1
1718,4,1,H,4,1,2242,2,1,67,31,0,5,30,53,27,55,28,-23,36,0,0,0,0
1718,3,1,H,2,0,2243,1,0,55,41,1,2,29,34,35,52,17,-5,14,0,0,0,0
1718,3,3,D,0,1,2244,0,1,17,33,0,3,43,56,78,29,-49,-13,-16,0,0,0,0
1718,1,2,A,1,4,2245,1,2,39,54,2,12,44,38,44,37,-7,6,-15,0,0,0,0
1718,4,1,H,0,1,2246,0,0,31,37,1,4,25,53,59,32,-27,-28,-6,0,0,0,0
1718,3,0,H,2,5,2247,1,3,51,84,0,15,71,23,38,47,9,48,-33,0,1,0,1
1718,4,1,H,3,2,2248,2,1,51,33,2,6,30,56,53,51,-2,-26,18,0,0,0,0
1718,0,1,A,3,3,2249,2,2,47,67,2,10,83,43,41,48,7,40,-20,0,0,0,0
1718,1,3,A,0,1,2250,0,1,25,29,2,4,30,55,68,27,-41,-25,-4,0,0,0,0
1718,3,1,H,5,1,2251,3,1,88,39,0,5,38,46,22,81,59,-8,49,1,0,1,0
1718,4,1,H,4,0,2252,2,0,57,25,0,2,28,71,39,46,7,-43,32,0,0,0,0
1718,0,1,A,2,4,2253,1,2,33,70,0,12,59,28,60,31,-29,31,-37,0,0,0,0
1718,2,1,H,1,0,2254,1,0,31,34,2,1,36,60,57,31,-26,-24,-3,0,0,0,0
1718,2,3,A,0,2,2255,0,1,41,54,2,6,50,38,37,30,-7,12,-13,0,0,0,0
1718,1,1,D,3,2,2256,2,1,70,58,1,7,55,36,43,84,41,19,12,0,0,0,0
1718,2,2,D,5,3,2257,3,2,84,47,0,11,48,42,26,71,45,6,37,1,0,1,0
1718,1,0,H,1,3,2258,0,2,37,54,1,11,55,54,57,26,-31,1,-17,0,0,0,0
1718,2,0,H,1,0,2259,1,0,32,18,1,0,32,81,56,33,-23,-49,14,0,0,0,0
1718,0,4,A,1,4,2260,1,3,34,66,0,13,58,26,59,46,-13,32,-32,0,0,0,1
1718,1,0,H,0,0,2261,0,0,18,41,0,2,32,40,83,32,-51,-8,-23,0,0,0,0
1718,1,2,A,4,1,2262,3,0,69,40,1,4,27,57,26,62,36,-30,29,0,0,1,0
1718,1,1,D,2,4,2263,1,2,59,60,1,12,50,40,37,56,19,10,-1,0,0,0,0
1718,1,2,A,1,1,2264,1,1,39,34,2,5,33,58,49,39,-10,-25,5,0,0,0,0
1718,2,2,D,0,3,2265,0,2,34,71,1,10,85,44,62,37,-25,41,-37,0,0,0,0
1718,0,1,A,2,2,2266,1,1,57,33,0,6,31,61,40,53,13,-30,24,0,0,0,0
1718,0,0,D,4,5,2267,2,3,73,91,0,15,84,23,28,60,32,61,-18,0,1,0,1
1718,0,2,A,3,5,2268,2,3,54,85,2,15,73,28,55,55,0,45,-31,0,1,0,1
1718,2,1,H,3,1,2269,2,1,48,35,2,4,35,56,44,50,6,-21,13,0,0,0,0
1718,0,1,A,0,1,2270,0,1,25,34,2,3,46,63,75,29,-46,-17,-9,0,0,0,0
1718,2,1,H,5,0,2271,3,0,92,25,0,2,29,76,23,84,61,-47,67,1,0,1,0
1718,1,0,H,2,2,2272,1,1,36,60,0,7,57,38,61,32,-29,19,-24,0,0,0,0
1718,1,0,H,1,0,2273,1,0,37,21,2,0,33,83,59,35,-24,-50,16,0,0,0,0
1718,1,2,A,0,3,2274,0,2,41,51,2,11,52,45,41,32,-9,7,-10,0,0,0,0
1718,2,3,A,3,4,2275,2,3,72,69,1,13,63,28,46,87,41,35,3,0,0,0,1
1718,5,1,H,4,2,2276,2,1,61,57,0,6,53,41,41,51,10,12,4,0,0,0,0
1718,2,1,H,5,0,2277,3,0,88,35,0,1,39,64,28,75,47,-25,53,1,0,1,0
1718,0,1,A,1,4,2278,0,2,43,74,1,12,60,28,58,29,-29,32,-31,0,0,0,0
1718,3,1,H,1,3,2279,1,2,35,54,1,11,55,57,58,36,-22,-2,-19,0,0,0,0
1718,1,0,H,1,1,2280,1,1,37,39,0,5,40,51,63,47,-16,-11,-2,0,0,0,0
1819,2,3,A,0,0,2281,0,0,0,0,0,0,0,0,0,0,0,0,0,0,0,0,0
1819,1,2,A,0,0,2282,0,0,0,0,0,0,0,0,0,0,0,0,0,0,0,0,0
1819,0,1,A,0,0,2283,0,0,0,0,0,0,0,0,0,0,0,0,0,0,0,0,0
1819,2,0,H,0,0,2284,0,0,0,0,0,0,0,0,0,0,0,0,0,0,0,0,0
1819,2,2,D,0,0,2285,0,0,0,0,0,0,0,0,0,0,0,0,0,0,0,0,0
1819,1,0,H,0,0,2286,0,0,0,0,0,0,0,0,0,0,0,0,0,0,0,0,0
1819,0,1,A,0,0,2287,0,0,0,0,0,0,0,0,0,0,0,0,0,0,0,0,0
1819,4,0,H,0,0,2288,0,0,0,0,0,0,0,0,0,0,0,0,0,0,0,0,0
1819,2,0,H,1,0,2289,1,0,3,0,0,0,1,2,2,3,1,-1,3,0,0,0,0
1819,3,2,H,1,0,2290,1,0,3,0,0,0,0,0,1,2,1,0,3,0,0,0,0
1819,2,2,D,0,1,2291,0,1,0,3,0,3,1,0,2,0,-2,1,-3,0,0,0,0
1819,6,1,H,0,0,2292,0,0,0,0,0,0,2,3,0,0,0,-1,0,0,0,0,0
1819,0,0,D,0,0,2293,0,0,0,0,0,0,0,1,4,0,-4,-1,0,0,0,0,0
1819,2,1,H,0,1,2294,0,1,0,3,0,3,2,0,0,0,0,2,0,0,0,0,0
1819,2,2,D,0,0,2295,0,0,0,0,0,0,0,1,1,0,-1,-1,0,0,0,0,0
1819,1,0,H,1,0,2296,1,0,3,1,0,1,2,2,0,1,1,0,2,0,0,0,0
1819,1,0,H,0,0,2297,0,0,1,0,1,0,0,0,2,2,0,0,1,0,0,0,0
1819,3,3,D,1,1,2298,1,1,3,3,0,3,4,0,0,1,1,4,0,0,0,0,0
1819,2,1,H,0,1,2299,0,1,0,4,0,4,4,3,3,2,-1,1,-4,0,0,0,0
1819,0,3,A,0,0,2300,0,0,1,1,1,1,2,3,1,0,-1,-1,0,0,0,0,0
1819,1,2,A,0,2,2301,0,2,1,6,1,6,5,2,3,2,-1,3,-5,0,0,0,0
1819,0,1,A,1,0,2302,1,0,4,1,1,1,2,4,3,7,4,-2,3,0,0,0,0
1819,0,0,D,0,1,2303,0,1,0,3,0,3,3,2,9,3,-6,1,-3,0,0,0,0
1819,1,0,H,1,1,2304,1,1,3,4,0,4,3,2,1,6,5,1,-1,0,0,0,0
1819,1,0,H,0,0,2305,0,0,0,1,0,1,0,4,4,1,-3,-4,-1,0,0,0,0
1819,3,0,H,0,2,2306,0,2,0,6,0,6,5,3,1,0,-1,2,-6,0,0,0,0
1819,5,3,H,1,1,2307,1,1,4,3,1,3,2,1,2,3,1,1,1,0,0,0,0
1819,1,0,H,0,2,2308,0,2,1,6,1,6,2,0,3,2,-1,2,-5,0,0,0,0
1819,0,5,A,0,1,2309,0,1,1,3,1,3,3,1,5,0,-5,2,-2,0,0,0,0
1819,0,1,A,1,0,2310,1,0,4,1,1,1,3,5,3,5,2,-2,3,0,0,0,0
1819,1,0,H,2,2,2311,2,2,6,6,0,6,7,1,6,5,-1,6,0,0,0,0,0
1819,1,1,D,1,1,2312,1,1,4,3,1,3,4,4,4,3,-1,0,1,0,0,0,0
1819,0,1,A,1,1,2313,1,1,4,3,1,3,2,4,2,3,1,-2,1,0,0,0,0
1819,1,0,H,1,0,2314,1,0,3,1,0,1,0,4,6,5,-1,-4,2,0,0,0,0
1819,2,1,H,3,2,2315,3,2,9,7,0,7,8,5,3,7,4,3,2,0,0,1,0
1819,2,2,D,1,0,2316,1,0,4,1,1,1,3,9,5,5,0,-6,3,0,0,0,0
1819,1,1,D,1,1,2317,1,1,4,4,1,4,3,3,3,3,0,0,0,0,0,0,0
1819,2,0,H,2,1,2318,2,1,6,4,0,4,7,4,1,2,1,3,2,0,0,0,0
1819,1,1,D,2,2,2319,2,2,6,6,0,6,7,2,1,8,7,5,0,0,0,0,0
1819,3,1,H,2,1,2320,2,1,7,4,1,4,3,3,7,9,2,0,3,0,0,0,0
1819,3,0,H,2,3,2321,2,2,7,9,1,9,4,1,3,8,5,3,-2,0,0,0,0
1819,2,0,H,1,1,2322,0,1,4,5,1,5,4,5,5,4,-1,-1,-1,0,0,0,0
1819,0,1,A,2,1,2323,2,1,7,4,1,4,5,4,2,9,7,1,3,0,0,0,0
1819,2,0,H,0,1,2324,0,1,1,5,1,5,7,7,5,0,-5,0,-4,0,0,0,0
1819,0,2,A,0,1,2325,0,1,2,5,2,5,4,4,11,5,-6,0,-3,0,0,0,0
1819,0,2,A,0,4,2326,0,3,1,12,1,12,9,4,10,0,-10,5,-11,0,0,0,1
1819,4,1,H,2,2,2327,1,2,6,6,0,6,6,6,4,3,-1,0,0,0,0,0,0
1819,2,2,D,1,1,2328,1,1,4,4,1,4,7,6,5,5,0,1,0,0,0,0,0
1819,1,3,A,1,3,2329,1,2,5,9,2,9,6,6,4,4,0,0,-4,0,0,0,0
1819,2,1,H,2,3,2330,1,2,7,10,1,10,11,3,4,6,2,8,-3,0,0,0,0
1819,0,0,D,1,1,2331,1,1,5,5,2,5,5,7,8,9,1,-2,0,0,0,0,0
1819,0,0,D,1,2,2332,1,2,5,7,2,7,9,3,7,4,-3,6,-2,0,0,0,0
1819,2,0,H,2,0,2333,2,0,6,2,0,2,5,13,10,7,-3,-8,4,0,0,0,0
1819,2,0,H,5,1,2334,3,0,15,4,0,4,2,5,4,11,7,-3,11,1,0,1,0
1819,3,0,H,4,2,2335,2,0,12,7,0,7,6,5,7,9,2,1,5,0,0,0,0
1819,4,0,H,1,0,2336,1,0,5,1,2,1,0,12,9,7,-2,-12,4,0,0,0,0
1819,1,2,A,2,3,2337,1,1,8,9,2,9,7,5,4,6,2,2,-1,0,0,0,0
1819,1,1,D,1,1,2338,1,1,4,5,1,5,7,7,6,4,-2,0,-1,0,0,0,0
1819,0,2,A,3,3,2339,2,2,9,10,0,10,12,8,4,4,0,4,-1,0,0,0,0
1819,2,0,H,2,1,2340,1,1,10,6,1,5,4,7,5,8,3,-3,4,0,0,0,0
1819,3,1,H,5,4,2341,3,2,18,15,0,12,12,7,4,13,9,5,3,1,0,1,0
1819,3,1,H,1,3,2342,1,1,8,12,2,9,9,6,9,11,2,3,-4,0,0,0,0
1819,2,1,H,1,2,2343,0,1,4,8,1,8,7,6,7,2,-5,1,-4,0,0,0,0
1819,0,1,A,0,1,2344,0,1,2,6,2,5,5,7,15,5,-10,-2,-4,0,0,0,0
1819,2,0,H,3,1,2345,2,1,10,6,1,5,9,8,5,12,7,1,4,0,0,0,0
1819,1,2,A,0,3,2346,0,2,1,9,1,9,9,10,16,0,-16,-1,-8,0,0,0,0
1819,1,0,H,2,1,2347,0,1,7,5,1,4,5,7,8,6,-2,-2,2,0,0,0,0
1819,1,4,A,3,1,2348,2,1,13,6,1,6,8,8,8,14,6,0,7,0,0,0,0
1819,2,1,H,2,3,2349,2,2,8,9,1,9,4,6,3,9,6,-2,-1,0,0,0,0
1819,3,2,H,1,0,2350,1,0,9,1,2,1,1,18,7,6,-1,-17,8,0,0,0,0
1819,2,0,H,1,1,2351,1,0,6,7,2,4,4,8,9,4,-5,-4,-1,0,0,0,0
1819,0,2,A,1,1,2352,1,1,5,11,1,5,14,10,8,5,-3,4,-6,0,0,0,0
1819,0,2,A,2,5,2353,1,3,8,21,2,15,16,5,8,8,0,11,-13,0,1,0,1
1819,0,1,A,1,2,2354,1,2,6,11,2,7,11,4,10,9,-1,7,-5,0,0,0,0
1819,1,3,A,3,2,2355,2,0,12,10,0,7,7,8,11,11,0,-1,2,0,0,0,0
1819,1,0,H,3,3,2356,1,2,12,13,0,10,14,5,9,10,1,9,-1,0,0,0,0
1819,3,1,H,1,0,2357,1,0,9,2,3,2,5,16,9,12,3,-11,7,0,0,0,0
1819,2,0,H,4,3,2358,2,2,15,13,0,10,15,12,10,13,3,3,2,0,0,0,0
1819,1,2,A,3,2,2359,2,1,9,13,0,7,10,5,8,5,-3,5,-4,0,0,0,0
1819,1,1,D,5,3,2360,3,2,24,12,0,9,12,14,5,18,13,-2,12,1,0,1,0
1819,0,2,A,1,3,2361,1,2,14,9,2,9,6,10,10,16,6,-4,5,0,0,0,0
1819,0,3,A,2,4,2362,1,2,8,18,2,12,15,10,10,8,-2,5,-10,0,0,0,0
1819,2,2,D,1,1,2363,0,1,7,12,1,5,9,9,10,4,-6,0,-5,0,0,0,0
1819,1,5,A,0,1,2364,0,1,2,6,2,5,9,11,19,6,-13,-2,-4,0,0,0,0
1819,1,1,D,3,1,2365,2,1,13,9,1,5,6,9,6,14,8,-3,4,0,0,0,0
1819,3,3,D,0,1,2366,0,1,1,5,1,4,5,10,21,3,-18,-5,-4,0,0,0,0
1819,1,0,H,2,1,2367,1,1,16,12,1,6,15,10,6,12,6,5,4,0,0,0,0
1819,0,2,A,2,3,2368,0,1,13,15,1,9,11,9,9,10,1,2,-2,0,0,0,0
1819,0,0,D,2,3,2369,2,2,14,13,1,10,15,14,4,12,8,1,1,0,0,0,0
1819,3,0,H,1,2,2370,1,0,9,13,2,7,10,11,12,14,2,-1,-4,0,0,0,0
1819,1,2,A,1,5,2371,1,3,6,25,1,15,19,6,13,8,-5,13,-19,0,1,0,1
1819,1,1,D,1,3,2372,1,2,13,14,2,10,15,7,11,11,0,8,-1,0,0,0,0
1819,2,1,H,1,0,2373,1,0,10,2,2,2,7,24,10,7,-3,-17,8,0,0,0,0
1819,2,2,D,3,2,2374,2,1,13,8,0,8,8,13,15,13,-2,-5,5,0,0,0,0
1819,3,2,H,1,2,2375,1,2,12,15,3,7,12,4,11,15,4,8,-3,0,0,0,0
1819,1,1,D,4,1,2376,2,1,21,14,0,5,16,12,10,18,8,4,7,0,0,0,0
1819,2,2,D,3,1,2377,2,0,14,8,1,4,6,12,14,15,1,-6,6,0,0,0,0
1819,0,3,A,3,0,2378,2,0,12,2,0,1,6,24,10,8,-2,-18,10,0,0,0,0
1819,0,3,A,3,2,2379,1,1,18,19,0,7,13,6,9,13,4,7,-1,0,0,0,0
1819,2,1,H,1,3,2380,1,2,15,14,3,9,15,17,13,18,5,-2,1,0,0,0,0
1819,5,1,H,4,1,2381,2,1,22,6,0,4,9,15,11,19,8,-6,16,0,0,0,0
1819,1,1,D,3,1,2382,2,1,15,15,1,5,17,13,8,16,8,4,0,0,0,0,0
1819,5,0,H,2,3,2383,1,2,22,14,1,9,16,19,6,16,10,-3,8,0,0,0,0
1819,3,1,H,5,1,2384,3,1,28,13,0,5,9,11,7,21,14,-2,15,1,0,1,0
1819,1,2,A,1,1,2385,0,1,9,12,1,5,17,12,14,8,-6,5,-3,0,0,0,0
1819,0,2,A,0,3,2386,0,2,2,15,2,10,17,16,26,8,-18,1,-13,0,0,0,0
1819,4,1,H,3,3,2387,1,2,18,12,0,9,8,13,12,13,1,-5,6,0,0,0,0
1819,0,0,D,2,0,2388,0,0,13,5,1,1,9,24,14,10,-4,-15,8,0,0,0,0
1819,1,4,A,2,1,2389,2,1,15,14,1,5,12,12,7,14,7,0,1,0,0,0,0
1819,0,1,A,2,1,2390,1,1,9,18,2,6,20,14,15,10,-5,6,-9,0,0,0,0
1819,1,1,D,0,3,2391,0,2,6,16,1,10,17,9,24,9,-15,8,-10,0,0,0,0
1819,1,2,A,3,4,2392,2,2,14,25,0,12,24,12,24,16,-8,12,-11,0,0,0,0
1819,2,2,D,3,1,2393,2,1,12,13,0,5,10,14,17,9,-8,-4,-1,0,0,0,0
1819,1,2,A,1,2,2394,1,0,17,14,2,7,10,14,13,16,3,-4,3,0,0,0,0
1819,4,1,H,1,2,2395,1,1,15,25,2,7,21,6,13,19,6,15,-10,0,0,0,0
1819,2,2,D,0,1,2396,0,0,2,9,2,4,9,16,28,8,-20,-7,-7,0,0,0,0
1819,2,1,H,1,2,2397,1,1,6,9,1,8,10,16,20,10,-10,-6,-3,0,0,0,0
1819,0,2,A,1,5,2398,1,3,21,31,3,15,24,8,14,21,7,16,-10,0,1,0,1
1819,4,1,H,1,2,2399,1,2,16,15,2,7,15,11,14,18,4,4,1,0,0,0,0
1819,1,1,D,3,3,2400,2,1,18,21,1,9,17,13,16,19,3,4,-3,0,0,0,0
1819,3,0,H,2,0,2401,1,0,25,7,1,1,10,25,10,22,12,-15,18,0,0,0,0
1819,2,0,H,5,3,2402,3,2,34,13,0,9,11,19,8,26,18,-8,21,1,0,1,0
1819,1,0,H,2,1,2403,1,1,9,19,2,5,22,15,18,11,-7,7,-10,0,0,0,0
1819,0,0,D,1,3,2404,0,2,10,17,1,10,18,10,18,11,-7,8,-7,0,0,0,0
1819,3,2,H,1,1,2405,1,1,9,18,1,5,23,14,21,12,-9,9,-9,0,0,0,0
1819,1,1,D,3,2,2406,2,2,14,15,0,7,16,15,26,17,-9,1,-1,0,0,0,0
1819,1,1,D,3,1,2407,1,1,22,21,0,6,21,16,14,18,4,5,1,0,0,0,0
1819,0,0,D,4,0,2408,2,0,28,3,0,2,10,30,13,26,13,-20,25,0,0,0,0
1819,2,1,H,2,3,2409,0,2,17,19,1,10,20,17,15,12,-3,3,-2,0,0,0,0
1819,0,0,D,1,1,2410,1,1,14,17,2,5,17,15,16,12,-4,2,-3,0,0,0,0
1819,0,3,A,3,5,2411,2,3,18,37,1,15,28,8,10,18,8,20,-19,0,1,0,1
1819,4,1,H,2,1,2412,2,0,16,11,1,4,11,18,16,17,1,-7,5,0,0,0,0
1819,2,2,D,3,1,2413,2,1,13,12,0,4,15,23,21,11,-10,-8,1,0,0,0,0
1819,1,1,D,0,3,2414,0,1,4,23,2,9,19,15,30,10,-20,4,-19,0,0,0,0
1819,1,1,D,0,1,2415,0,1,7,15,1,5,12,16,28,10,-18,-4,-8,0,0,0,0
1819,2,1,H,1,2,2416,1,0,22,20,3,7,14,16,17,22,5,-2,2,0,0,0,0
1819,2,2,D,1,2,2417,1,1,19,28,2,7,25,10,16,22,6,15,-9,0,0,0,0
1819,0,0,D,3,2,2418,2,1,19,12,1,8,12,18,19,21,2,-6,7,0,0,0,0
1819,2,1,H,1,3,2419,1,2,18,15,2,9,18,27,15,17,2,-9,3,0,0,0,0
1819,1,2,A,1,4,2420,1,2,18,29,2,12,26,13,17,25,8,13,-11,0,0,0,0
1819,1,0,H,5,2,2421,3,1,40,29,0,7,27,12,8,31,23,15,11,1,0,1,0
1819,2,2,D,1,1,2422,1,1,16,20,2,5,24,18,17,13,-4,6,-4,0,0,0,0
1819,2,2,D,3,2,2423,1,2,24,19,0,7,21,17,16,20,4,4,5,0,0,0,0
1819,4,0,H,4,0,2424,2,0,32,8,0,1,11,29,14,28,14,-18,24,0,0,0,0
1819,2,1,H,1,1,2425,1,0,13,11,1,4,12,22,25,17,-8,-10,2,0,0,0,0
1819,1,1,D,3,3,2426,2,2,15,14,0,9,13,23,29,19,-10,-10,1,0,0,0,0
1819,0,0,D,1,1,2427,1,1,25,21,3,5,19,16,18,24,6,3,4,0,0,0,0
1819,1,1,D,2,0,2428,0,0,20,5,1,2,11,31,18,15,-3,-20,15,0,0,0,0
1819,3,3,D,3,3,2429,2,2,20,18,1,10,18,13,19,21,2,5,2,0,0,0,0
1819,1,3,A,2,1,2430,1,1,13,18,2,5,26,19,18,12,-6,7,-5,0,0,0,0
1819,1,0,H,2,2,2431,1,1,29,13,1,8,13,21,13,27,14,-8,16,0,0,0,0
1819,0,1,A,1,5,2432,1,3,22,43,2,15,32,8,16,19,3,24,-21,0,1,0,1
1819,0,1,A,1,4,2433,1,2,17,35,2,12,32,14,19,15,-4,18,-18,0,0,0,0
1819,3,1,H,3,1,2434,2,1,19,16,1,4,19,26,16,21,5,-7,3,0,0,0,0
1819,0,2,A,0,3,2435,0,2,8,21,1,10,24,22,33,11,-22,2,-13,0,0,0,0
1819,3,2,H,1,3,2436,1,2,21,16,2,9,20,30,20,26,6,-10,5,0,0,0,0
1819,2,0,H,2,2,2437,2,0,20,21,1,7,16,19,19,23,4,-3,-1,0,0,0,0
1819,0,0,D,3,0,2438,2,0,15,6,0,2,12,32,24,14,-10,-20,9,0,0,0,0
1819,1,0,H,1,3,2439,1,1,21,25,2,9,22,18,20,29,9,4,-4,0,0,0,0
1819,0,0,D,1,1,2440,0,1,11,26,1,6,24,18,24,13,-11,6,-15,0,0,0,0
1819,1,1,D,0,2,2441,0,1,7,32,2,7,28,13,32,12,-20,15,-25,0,0,0,0
1819,2,4,A,1,2,2442,1,2,16,23,1,7,25,19,29,20,-9,6,-7,0,0,0,0
1819,3,1,H,3,1,2443,2,1,16,24,0,5,30,20,33,22,-11,10,-8,0,0,0,0
1819,1,0,H,5,1,2444,3,1,46,24,0,5,29,22,8,33,25,7,22,1,0,1,0
1819,3,1,H,3,1,2445,1,1,25,17,0,5,15,20,19,22,3,-5,8,0,0,0,0
1819,0,1,A,1,3,2446,1,2,27,22,3,10,24,17,18,24,6,7,5,0,0,0,0
1819,1,0,H,4,3,2447,2,2,38,16,0,9,14,24,14,33,19,-10,22,0,0,0,0
1819,0,0,D,2,1,2448,0,0,21,12,1,4,13,24,21,16,-5,-11,9,0,0,0,0
1819,1,1,D,3,1,2449,2,1,24,22,1,5,19,17,22,26,4,2,2,0,0,0,0
1819,1,1,D,2,0,2450,1,0,13,8,2,1,11,35,22,13,-9,-24,5,0,0,0,0
1819,2,2,D,1,5,2451,1,3,24,49,2,15,34,8,23,31,8,26,-25,0,1,0,1
1819,0,2,A,1,3,2452,0,1,13,28,1,9,25,20,24,13,-11,5,-15,0,0,0,0
1819,1,0,H,1,3,2453,1,2,17,19,2,9,25,34,23,16,-7,-9,-2,0,0,0,0
1819,0,1,A,3,2,2454,2,0,25,22,1,7,16,21,17,25,8,-5,3,0,0,0,0
1819,0,0,D,0,1,2455,0,1,9,27,1,6,24,19,36,12,-24,5,-18,0,0,0,0
1819,1,0,H,2,4,2456,1,2,33,41,1,12,34,14,14,29,15,20,-8,0,0,0,0
1819,3,1,H,1,3,2457,1,2,24,25,2,10,27,23,23,29,6,4,-1,0,0,0,0
1819,2,0,H,2,0,2458,2,0,26,8,1,2,13,33,21,29,8,-20,18,0,0,0,0
1819,0,0,D,3,2,2459,2,1,16,14,0,8,14,23,25,14,-11,-9,2,0,0,0,0
1819,3,0,H,1,1,2460,1,1,23,16,2,4,22,33,18,20,2,-11,7,0,0,0,0
1819,1,0,H,0,0,2461,0,0,8,10,2,1,12,36,35,13,-22,-24,-2,0,0,0,0
1819,0,1,A,1,2,2462,1,1,16,36,1,7,30,14,36,22,-14,16,-20,0,0,0,0
1819,0,0,D,3,3,2463,2,2,19,25,0,10,25,18,35,25,-10,7,-6,0,0,0,0
1819,2,1,H,5,2,2464,3,2,50,29,0,7,31,21,10,36,26,10,21,1,0,1,0
1819,1,1,D,3,1,2465,1,1,31,26,0,5,23,18,20,27,7,5,5,0,0,0,0
1819,2,1,H,1,3,2466,1,2,28,17,3,9,14,25,19,24,5,-11,11,0,0,0,0
1819,3,2,H,4,1,2467,2,0,41,13,0,4,13,26,15,34,19,-13,28,0,0,0,0
1819,0,2,A,2,1,2468,0,1,25,27,1,5,32,24,21,17,-4,8,-2,0,0,0,0
1819,2,6,A,3,1,2469,2,1,25,25,1,5,33,25,26,28,2,8,0,0,0,0,0
1819,2,0,H,2,1,2470,1,1,15,20,2,5,17,23,23,14,-9,-6,-5,0,0,0,0
1819,0,0,D,2,3,2471,1,2,39,25,4,10,30,32,14,31,17,-2,14,0,0,0,0
1819,3,2,H,1,1,2472,1,1,30,27,2,5,24,19,24,34,10,5,3,0,0,0,0
1819,1,2,A,2,2,2473,1,0,18,25,2,7,17,23,23,16,-7,-6,-7,0,0,0,0
1819,2,2,D,1,1,2474,1,1,20,16,5,4,22,37,25,17,-8,-15,4,0,0,0,0
1819,3,3,D,3,2,2475,2,2,26,29,1,7,32,23,18,25,7,9,-3,0,0,0,0
1819,0,5,A,0,1,2476,0,1,10,28,4,5,39,27,37,12,-25,12,-18,0,0,0,0
1819,2,1,H,4,3,2477,2,1,44,32,0,9,28,21,17,37,20,7,12,0,0,0,0
1819,1,1,D,3,1,2478,2,0,17,13,0,4,15,29,27,15,-12,-14,4,0,0,0,0
1819,0,2,A,3,1,2479,2,1,20,31,0,6,26,20,35,25,-10,6,-11,0,0,0,0
1819,3,0,H,5,0,2480,3,0,53,11,0,2,14,35,11,38,27,-21,42,1,0,1,0
1819,0,0,D,1,4,2481,1,2,34,47,6,12,39,18,20,28,8,21,-13,0,0,0,0
1819,4,0,H,2,2,2482,2,1,30,18,4,8,17,25,26,35,9,-8,12,0,0,0,0
1819,3,0,H,3,1,2483,2,1,26,21,1,5,19,27,32,30,-2,-8,5,0,0,0,0
1819,3,3,D,1,1,2484,1,1,31,33,2,5,37,26,27,44,17,11,-2,0,0,0,0
1819,0,4,A,1,0,2485,0,0,14,10,1,1,12,42,30,16,-14,-30,4,0,0,0,0
1819,3,4,A,0,3,2486,0,2,11,27,5,10,28,21,38,14,-24,7,-16,0,0,0,0
1819,1,2,A,3,5,2487,1,3,32,56,3,15,41,11,23,29,6,30,-24,0,1,0,1
1819,2,3,A,2,3,2488,0,2,28,18,4,9,16,28,24,19,-5,-12,10,0,0,0,0
1819,1,0,H,1,2,2489,1,1,27,40,2,7,31,14,22,26,4,17,-13,0,0,0,0
1819,1,3,A,1,3,2490,1,2,17,20,4,9,25,37,39,24,-15,-12,-3,0,0,0,0
1819,2,2,D,1,0,2491,1,0,17,11,1,2,17,42,42,25,-17,-25,6,0,0,0,0
1819,3,3,D,5,2,2492,3,0,59,28,0,7,21,27,12,43,31,-6,31,1,0,1,0
1819,3,0,H,4,2,2493,2,2,48,33,3,7,39,26,18,39,21,13,15,0,0,0,0
1819,1,1,D,3,3,2494,2,2,23,29,3,10,33,32,38,28,-10,1,-6,0,0,0,0
1819,0,1,A,2,1,2495,1,0,40,14,1,4,16,34,15,31,16,-18,26,0,0,0,0
1819,1,1,D,1,1,2496,1,1,34,35,5,6,28,20,29,40,11,8,-1,0,0,0,0
1819,0,0,D,3,1,2497,2,1,21,30,3,5,27,22,30,19,-11,5,-9,0,0,0,0
1819,1,1,D,2,3,2498,1,2,18,30,5,10,32,24,29,17,-12,8,-12,0,0,0,0
1819,0,1,A,1,1,2499,1,1,21,32,2,5,47,30,30,19,-11,17,-11,0,0,0,0
1819,0,1,A,0,3,2500,0,1,13,32,4,9,30,25,42,16,-26,5,-19,0,0,0,0
1819,1,0,H,3,1,2501,1,1,35,18,0,4,27,44,25,31,6,-17,17,0,0,0,0
1819,0,3,A,0,1,2502,0,1,12,35,2,5,41,30,44,19,-25,11,-23,0,0,0,0
1819,0,0,D,3,4,2503,2,2,31,51,4,12,42,18,25,33,8,24,-20,0,0,0,0
1819,0,1,A,2,2,2504,0,1,29,40,1,7,31,16,30,24,-6,15,-11,0,0,0,0
1819,2,1,H,1,3,2505,1,2,35,22,5,9,19,30,30,48,18,-11,13,0,0,0,0
1819,1,1,D,1,3,2506,0,2,17,24,4,9,29,39,34,17,-17,-10,-7,0,0,0,0
1819,3,0,H,1,1,2507,1,1,36,21,3,5,19,31,21,29,8,-12,15,0,0,0,0
1819,0,1,A,2,0,2508,2,0,33,13,1,1,16,43,29,39,10,-27,20,0,0,0,0
1819,0,3,A,3,5,2509,2,3,30,60,4,15,46,15,33,34,1,31,-30,0,1,0,1
1819,1,0,H,1,2,2510,1,1,31,19,2,8,18,30,22,27,5,-12,12,0,0,0,0
1819,3,0,H,5,0,2511,3,0,63,16,0,1,17,43,15,49,34,-26,47,1,0,1,0
1819,1,3,A,1,1,2512,1,1,38,39,2,6,32,21,31,50,19,11,-1,0,0,0,0
1819,2,1,H,1,2,2513,1,0,21,29,5,7,24,31,34,19,-15,-7,-8,0,0,0,0
1819,3,0,H,1,3,2514,1,2,18,30,4,10,34,36,45,27,-18,-2,-12,0,0,0,0
1819,2,1,H,3,3,2515,2,1,25,38,3,9,32,25,40,30,-10,7,-13,0,0,0,0
1819,2,1,H,2,2,2516,1,2,43,33,1,7,39,30,16,32,16,9,10,0,0,0,0
1819,0,0,D,4,1,2517,2,1,52,34,0,5,28,22,18,42,24,6,18,0,0,0,0
1819,1,4,A,3,3,2518,2,2,22,32,3,10,33,25,32,20,-12,8,-10,0,0,0,0
1819,1,0,H,2,0,2519,1,0,19,12,2,2,19,47,31,18,-13,-28,7,0,0,0,0
1819,2,1,H,1,1,2520,1,0,38,18,5,4,18,35,30,44,14,-17,20,0,0,0,0
1819,3,0,H,1,1,2521,1,1,42,21,3,4,30,45,22,35,13,-15,21,0,0,0,0
1819,2,3,A,0,1,2522,0,1,16,41,1,5,46,31,46,17,-29,15,-25,0,0,0,0
1819,2,0,H,1,1,2523,1,1,35,38,2,5,51,34,22,28,6,17,-3,0,0,0,0
1819,0,1,A,1,5,2524,0,3,18,66,1,15,52,15,37,19,-18,37,-48,0,1,0,1
1819,0,0,D,0,3,2525,0,2,12,28,2,9,32,41,48,19,-29,-9,-16,0,0,0,0
1819,3,3,D,3,2,2526,2,1,35,46,1,7,34,17,26,37,11,17,-11,0,0,0,0
1819,0,4,A,2,4,2527,0,2,29,53,1,12,42,18,33,25,-8,24,-24,0,0,0,0
1819,1,0,H,2,1,2528,2,1,33,24,1,5,21,35,32,40,8,-14,9,0,0,0,0
1819,1,1,D,3,3,2529,2,2,30,22,1,9,21,36,39,34,-5,-15,8,0,0,0,0
1819,2,1,H,1,2,2530,1,1,24,47,2,7,37,20,36,21,-15,17,-23,0,0,0,0
1819,3,3,D,1,2,2531,1,0,21,29,1,7,25,37,48,30,-18,-12,-8,0,0,0,0
1819,3,0,H,3,1,2532,1,1,38,44,0,5,49,33,27,33,6,16,-6,0,0,0,0
1819,1,0,H,1,3,2533,1,2,45,31,3,10,35,40,22,38,16,-5,14,0,0,0,0
1819,3,1,H,1,3,2534,1,2,38,36,2,10,40,29,36,51,15,11,2,0,0,0,0
1819,0,0,D,3,0,2535,2,0,29,16,0,1,19,49,41,32,-9,-30,13,0,0,0,0
1819,1,2,A,4,5,2536,2,3,56,69,0,15,53,15,18,46,28,38,-13,0,1,0,1
1819,1,2,A,3,2,2537,2,2,23,36,0,7,41,32,37,22,-15,9,-13,0,0,0,0
1819,3,0,H,1,0,2538,1,0,38,13,2,2,19,48,22,30,8,-29,25,0,0,0,0
1819,2,1,H,2,1,2539,1,0,22,18,2,4,19,38,31,19,-12,-19,4,0,0,0,0
1819,4,1,H,5,2,2540,3,1,72,25,0,8,21,32,16,55,39,-11,47,1,0,1,0
1819,1,2,A,0,1,2541,0,1,13,48,2,6,39,22,51,19,-32,17,-35,0,0,0,0
1819,1,0,H,2,3,2542,0,2,30,30,1,9,32,41,40,28,-12,-9,0,0,0,0,0
1819,2,0,H,1,1,2543,0,1,18,27,1,5,23,37,40,20,-20,-14,-9,0,0,0,0
1819,1,1,D,3,3,2544,2,1,36,41,1,9,36,27,32,41,9,9,-5,0,0,0,0
1819,1,2,A,0,1,2545,0,1,17,41,1,5,33,22,49,19,-30,11,-24,0,0,0,0
1819,2,0,H,2,3,2546,1,2,47,23,1,9,23,39,22,38,16,-16,24,0,0,0,0
1819,1,2,A,2,1,2547,2,1,39,41,1,5,54,37,33,43,10,17,-2,0,0,0,0
1819,1,1,D,3,4,2548,2,2,31,56,1,12,47,20,41,35,-6,27,-25,0,0,0,0
1819,2,1,H,1,1,2549,1,1,44,22,2,4,33,51,36,49,13,-18,22,0,0,0,0
1819,2,1,H,1,3,2550,1,2,27,37,2,10,42,33,39,23,-16,9,-10,0,0,0,0
1819,3,5,A,3,2,2551,2,2,32,39,1,7,44,35,42,36,-6,9,-7,0,0,0,0
1819,2,1,H,3,1,2552,2,1,23,47,0,5,51,37,41,23,-18,14,-24,0,0,0,0
1819,2,3,A,1,1,2553,1,0,44,21,2,4,22,40,23,35,12,-18,23,0,0,0,0
1819,1,1,D,1,0,2554,1,0,44,13,2,2,20,53,38,56,18,-33,31,0,0,0,0
1819,2,1,H,1,0,2555,1,0,22,17,1,1,20,51,53,34,-19,-31,5,0,0,0,0
1819,2,0,H,3,5,2556,2,3,30,75,0,15,59,17,42,32,-10,42,-45,0,1,0,1
1819,4,1,H,3,2,2557,1,0,42,33,0,7,29,40,28,37,9,-11,9,0,0,0,0
1819,2,3,A,1,2,2558,1,1,51,50,3,7,40,22,23,41,18,18,1,0,0,0,0
1819,4,2,H,4,2,2559,2,1,57,25,0,8,22,36,21,48,27,-14,32,0,0,0,0
1819,0,3,A,0,1,2560,0,1,14,30,2,5,25,40,54,21,-33,-15,-16,0,0,0,0
1819,1,0,H,5,1,2561,3,1,75,25,0,4,36,54,19,59,40,-18,50,1,0,1,0
1819,1,0,H,2,1,2562,2,1,42,51,1,6,43,26,38,49,11,17,-9,0,0,0,0
1819,2,0,H,2,3,2563,1,2,25,33,2,9,34,42,40,24,-16,-8,-8,0,0,0,0
1819,2,1,H,1,3,2564,0,2,24,32,1,10,39,47,42,25,-17,-8,-8,0,0,0,0
1819,1,1,D,3,1,2565,2,1,37,44,1,5,37,26,35,43,8,11,-7,0,0,0,0
1819,0,1,A,0,3,2566,0,2,17,26,1,9,25,42,53,21,-32,-17,-9,0,0,0,0
1819,0,1,A,2,3,2567,1,1,53,45,1,9,41,29,24,43,19,12,8,0,0,0,0
1819,1,3,A,2,1,2568,0,1,33,45,1,5,57,39,44,30,-14,18,-12,0,0,0,0
1819,1,4,A,1,4,2569,1,2,47,60,2,12,52,23,39,52,13,29,-13,0,0,0,0
1819,0,2,A,1,5,2570,1,3,33,78,2,15,60,19,40,28,-12,41,-45,0,1,0,1
1819,1,1,D,1,2,2571,1,1,51,28,3,8,26,40,27,43,16,-14,23,0,0,0,0
1819,2,1,H,1,4,2572,1,2,25,63,1,12,56,24,55,36,-19,32,-38,0,0,0,0
1819,3,2,H,0,2,2573,0,0,17,33,1,7,31,47,54,21,-33,-16,-16,0,0,0,0
1819,0,4,A,3,2,2574,2,1,33,53,0,7,43,25,44,34,-10,18,-20,0,0,0,0
1819,2,2,D,1,3,2575,1,2,47,38,2,10,44,36,43,53,10,8,9,0,0,0,0
1819,1,0,H,3,3,2576,2,1,29,48,0,9,42,29,42,26,-16,13,-19,0,0,0,0
1819,2,1,H,1,2,2577,1,2,45,45,2,7,50,38,27,38,11,12,0,0,0,0,0
1819,4,1,H,1,1,2578,1,0,48,27,2,4,27,43,40,60,20,-16,21,0,0,0,0
1819,4,0,H,3,0,2579,2,0,32,14,1,2,21,57,49,40,-9,-36,18,0,0,0,0
1819,2,1,H,5,1,2580,3,1,81,52,0,6,44,28,19,62,43,16,29,1,0,1,0
1819,0,0,D,2,1,2581,0,1,33,48,1,5,40,28,50,33,-17,12,-15,0,0,0,0
1819,0,1,A,2,1,2582,2,1,45,48,1,5,55,45,40,51,11,10,-3,0,0,0,0
1819,2,1,H,1,3,2583,1,2,33,32,2,9,27,42,42,28,-14,-15,1,0,0,0,0
1819,0,1,A,3,0,2584,2,0,39,20,1,1,24,56,38,46,8,-32,19,0,0,0,0
1819,0,0,D,2,1,2585,1,1,56,51,1,5,64,41,25,47,22,23,5,0,0,0,0
1819,2,2,D,3,3,2586,1,2,48,35,0,10,44,49,30,42,12,-5,13,0,0,0,0
1819,1,1,D,4,3,2587,2,2,63,33,0,9,34,48,26,57,31,-14,30,0,0,0,0
1819,3,2,H,2,1,2588,1,1,29,28,2,4,38,56,41,27,-14,-18,1,0,0,0,0
1819,3,0,H,1,0,2589,0,0,27,14,1,2,21,61,47,28,-19,-40,13,0,0,0,0
1819,1,0,H,1,3,2590,1,1,52,49,3,9,44,32,30,45,15,12,3,0,0,0,0
1819,1,0,H,1,2,2591,1,1,51,32,2,8,30,43,45,56,11,-13,19,0,0,0,0
1819,2,1,H,3,5,2592,2,3,32,84,0,15,64,20,44,28,-16,44,-52,0,1,0,1
1819,1,3,A,0,4,2593,0,2,14,64,2,12,58,27,64,21,-43,31,-50,0,0,0,0
1819,0,0,D,3,1,2594,2,0,39,30,1,4,31,47,39,46,7,-16,9,0,0,0,0
1819,1,3,A,0,2,2595,0,1,23,57,1,7,47,25,56,25,-31,22,-34,0,0,0,0
1819,2,0,H,2,3,2596,2,2,45,34,1,9,35,49,41,51,10,-14,11,0,0,0,0
1819,0,0,D,3,2,2597,2,0,36,34,1,7,33,50,51,46,-5,-17,2,0,0,0,0
1819,1,1,D,1,1,2598,1,1,49,36,2,5,30,43,28,40,12,-13,13,0,0,0,0
1819,0,0,D,1,1,2599,1,1,52,28,2,4,40,59,41,64,23,-19,24,0,0,0,0
1819,2,0,H,3,2,2600,1,1,49,32,0,8,30,44,33,44,11,-14,17,0,0,0,0
1819,3,0,H,1,2,2601,0,2,31,48,1,7,53,41,47,31,-16,12,-17,0,0,0,0
1819,1,0,H,1,0,2602,1,0,37,23,2,1,26,59,44,31,-13,-33,14,0,0,0,0
1819,2,4,A,1,3,2603,1,2,29,35,1,9,30,45,59,40,-19,-15,-6,0,0,0,0
1819,0,1,A,3,1,2604,2,1,34,50,0,5,41,29,51,35,-16,12,-16,0,0,0,0
1819,1,1,D,2,1,2605,1,1,60,54,1,5,57,45,26,50,24,12,6,0,0,0,0
1819,2,1,H,5,3,2606,3,2,84,40,0,10,46,39,22,65,43,7,44,1,0,1,0
1819,1,2,A,3,0,2607,1,0,52,14,0,2,22,67,33,46,13,-45,38,0,0,0,0
1819,1,1,D,2,1,2608,0,1,35,55,1,6,46,30,50,33,-17,16,-20,0,0,0,0
1819,1,1,D,2,3,2609,1,2,32,37,2,10,46,51,46,30,-16,-5,-5,0,0,0,0
1819,1,2,A,4,1,2610,2,1,67,53,0,5,64,41,28,61,33,23,14,0,0,0,0
1819,3,1,H,1,1,2611,0,1,34,29,1,4,42,63,47,34,-13,-21,5,0,0,0,0
1819,1,1,D,2,5,2612,1,3,61,87,1,15,67,23,27,51,24,44,-26,0,1,0,1
1819,3,0,H,1,1,2613,1,1,55,40,2,5,32,44,46,58,12,-12,15,0,0,0,0
1819,1,1,D,0,2,2614,0,0,17,36,2,7,34,51,68,24,-44,-17,-19,0,0,0,0
1819,0,2,A,0,4,2615,0,2,23,67,1,12,62,30,60,26,-34,32,-44,0,0,0,0
1819,1,2,A,2,3,2616,2,1,48,52,1,9,47,35,44,53,9,12,-4,0,0,0,0
1819,1,1,D,3,3,2617,2,2,38,34,0,9,35,52,47,34,-13,-17,4,0,0,0,0
1819,2,0,H,1,1,2618,1,1,53,56,2,6,47,31,29,42,13,16,-3,0,0,0,0
1819,2,0,H,1,2,2619,1,1,56,33,2,8,31,47,42,66,24,-16,23,0,0,0,0
1819,0,1,A,3,3,2620,2,2,40,38,1,10,47,52,41,47,6,-5,2,0,0,0,0
1819,1,1,D,5,1,2621,3,1,88,56,0,5,44,29,24,68,44,15,32,1,0,1,0
1819,0,4,A,0,3,2622,0,2,18,39,2,9,35,48,69,25,-44,-13,-21,0,0,0,0
1819,0,0,D,2,2,2623,1,1,33,62,2,7,52,28,49,31,-18,24,-29,0,0,0,0
1819,1,0,H,1,3,2624,1,2,29,40,1,10,47,42,66,43,-23,5,-11,0,0,0,0
1819,1,1,D,3,1,2625,2,1,35,58,0,5,61,46,53,36,-17,15,-23,0,0,0,0
1819,1,3,A,3,1,2626,1,1,55,59,0,5,68,42,36,49,13,26,-4,0,0,0,0
1819,2,1,H,4,1,2627,2,1,70,40,0,5,32,47,30,64,34,-15,30,0,0,0,0
1819,3,3,D,2,2,2628,0,2,37,48,1,7,54,46,52,35,-17,8,-11,0,0,0,0
1819,2,2,D,3,0,2629,2,0,41,23,1,1,26,62,52,48,-4,-36,18,0,0,0,0
1819,2,1,H,1,1,2630,1,0,56,37,3,4,37,48,33,47,14,-11,19,0,0,0,0
1819,2,1,H,1,3,2631,1,2,62,36,2,9,37,54,43,71,28,-17,26,0,0,0,0
1819,1,2,A,1,3,2632,1,1,40,55,2,9,50,39,49,33,-16,11,-15,0,0,0,0
1819,0,1,A,3,1,2633,2,1,40,59,1,6,49,34,43,47,4,15,-19,0,0,0,0
1819,1,3,A,0,2,2634,0,1,24,34,1,8,31,49,64,28,-36,-18,-10,0,0,0,0
1819,2,0,H,1,5,2635,1,3,59,89,2,15,69,25,47,62,15,44,-30,0,1,0,1
1819,1,2,A,2,1,2636,2,1,49,32,1,4,44,66,49,57,8,-22,17,0,0,0,0
1819,1,2,A,3,4,2637,2,2,42,73,0,12,66,31,48,39,-9,35,-31,0,0,0,0
1819,3,2,H,1,3,2638,1,2,57,42,2,10,50,54,30,45,15,-4,15,0,0,0,0
1819,4,1,H,1,2,2639,0,0,37,38,1,7,38,55,50,38,-12,-17,-1,0,0,0,0
1819,2,0,H,2,0,2640,1,0,63,18,1,2,25,73,28,52,24,-48,45,0,0,0,0
1819,1,1,D,3,1,2641,2,1,36,40,0,5,34,51,56,38,-18,-17,-4,0,0,0,0
1819,0,0,D,3,1,2642,2,1,42,62,1,5,64,47,57,52,-5,17,-20,0,0,0,0
1819,3,2,H,2,3,2643,1,2,37,42,2,9,40,50,50,34,-16,-10,-5,0,0,0,0
1819,0,0,D,0,2,2644,0,2,18,49,2,7,58,51,75,25,-50,7,-31,0,0,0,0
1819,4,1,H,1,1,2645,1,1,35,60,1,5,48,32,67,46,-21,16,-25,0,0,0,0
1819,1,1,D,5,1,2646,3,1,89,65,0,5,73,44,27,69,42,29,24,1,0,1,0
1819,2,0,H,1,0,2647,1,0,62,24,3,1,29,67,34,50,16,-38,38,0,0,0,0
1819,4,1,H,4,2,2648,2,1,76,66,0,7,54,28,32,68,36,26,10,0,0,0,0
1819,1,0,H,2,3,2649,0,2,38,40,1,10,47,44,59,39,-20,3,-2,0,0,0,0
1819,3,3,D,3,1,2650,1,0,58,40,0,4,42,51,40,52,12,-9,18,0,0,0,0
1819,3,2,H,1,4,2651,0,2,41,79,1,12,72,33,54,45,-9,39,-38,0,0,0,0
1819,0,0,D,0,0,2652,0,0,24,19,1,2,25,75,69,29,-40,-50,5,0,0,0,0
1819,3,1,H,1,3,2653,1,2,66,43,2,10,52,57,45,74,29,-5,23,0,0,0,0
1819,1,2,A,1,2,2654,1,1,41,40,2,8,37,52,52,35,-17,-15,1,0,0,0,0
1819,0,0,D,3,3,2655,2,2,40,37,1,9,39,57,45,47,2,-18,3,0,0,0,0
1819,2,1,H,2,1,2656,1,1,66,38,1,4,50,68,32,55,23,-18,28,0,0,0,0
1819,2,1,H,1,2,2657,1,0,63,41,2,7,40,59,47,64,17,-19,22,0,0,0,0
1819,2,0,H,2,5,2658,2,3,50,90,1,15,70,28,51,58,7,42,-40,0,1,0,1
1819,2,3,A,3,1,2659,2,1,42,65,0,6,52,34,53,42,-11,18,-23,0,0,0,0
1819,3,1,H,1,3,2660,1,1,60,59,2,9,55,43,36,49,13,12,1,0,0,0,0
1920,0,1,A,0,0,2661,0,0,0,0,0,0,0,0,0,0,0,0,0,0,0,0,0
1920,3,4,A,0,0,2662,0,0,0,0,0,0,0,0,0,0,0,0,0,0,0,0,0
1920,1,0,H,0,0,2663,0,0,0,0,0,0,0,0,0,0,0,0,0,0,0,0,0
1920,0,1,A,0,0,2664,0,0,0,0,0,0,0,0,0,0,0,0,0,0,0,0,0
1920,3,3,D,0,0,2665,0,0,0,0,0,0,0,0,0,0,0,0,0,0,0,0,0
1920,0,3,A,0,0,2666,0,0,0,0,0,0,0,0,0,0,0,0,0,0,0,0,0
1920,2,3,A,0,0,2667,0,0,0,0,0,0,0,0,0,0,0,0,0,0,0,0,0
1920,2,1,H,0,0,2668,0,0,0,0,0,0,0,0,0,0,0,0,0,0,0,0,0
1920,1,1,D,0,0,2669,0,0,0,0,0,0,0,0,0,0,0,0,0,0,0,0,0
1920,4,0,H,0,0,2670,0,0,0,0,0,0,0,0,0,0,0,0,0,0,0,0,0
1920,1,0,H,0,0,2671,0,0,1,0,1,0,2,3,1,1,0,-1,1,0,0,0,0
1920,1,0,H,0,1,2672,0,1,0,3,0,3,1,0,1,0,-1,1,-3,0,0,0,0
1920,4,3,H,1,1,2673,1,1,3,3,0,3,4,3,0,1,1,1,0,0,0,0,0
1920,1,1,D,1,0,2674,1,0,3,1,0,1,3,3,0,3,3,0,2,0,0,0,0
1920,2,3,A,1,1,2675,1,1,3,3,0,3,2,1,2,3,1,1,0,0,0,0,0
1920,1,2,A,0,1,2676,0,1,0,3,0,3,4,0,1,0,-1,4,-3,0,0,0,0
1920,2,1,H,0,0,2677,0,0,1,0,1,0,3,4,3,3,0,-1,1,0,0,0,0
1920,0,1,A,0,0,2678,0,0,0,1,0,1,1,1,4,0,-4,0,-1,0,0,0,0
1920,4,1,H,0,0,2679,0,0,0,0,0,0,0,3,2,1,-1,-3,0,0,0,0,0
1920,1,3,A,1,0,2680,1,0,3,0,0,0,0,1,0,1,1,-1,3,0,0,0,0
1920,0,0,D,0,2,2681,0,2,0,6,0,6,5,3,6,4,-2,2,-6,0,0,0,0
1920,2,0,H,1,0,2682,1,0,3,0,0,0,1,7,7,7,0,-6,3,0,0,0,0
1920,1,0,H,2,1,2683,2,1,6,3,0,3,2,3,1,6,5,-1,3,0,0,0,0
1920,1,2,A,1,1,2684,1,1,4,3,1,3,5,5,4,5,1,0,1,0,0,0,0
1920,3,4,A,1,1,2685,1,1,3,4,0,4,2,1,1,1,0,1,-1,0,0,0,0
1920,1,3,A,1,0,2686,1,0,3,0,0,0,1,3,2,3,1,-2,3,0,0,0,0
1920,2,1,H,0,1,2687,0,1,0,4,0,4,4,1,4,2,-2,3,-4,0,0,0,0
1920,4,2,H,0,1,2688,0,1,2,3,2,3,5,3,4,4,0,2,-1,0,0,0,0
1920,0,1,A,1,1,2689,1,1,4,3,1,3,1,1,1,2,1,0,1,0,0,0,0
1920,1,2,A,2,0,2690,2,0,6,0,0,0,0,5,3,5,2,-5,6,0,0,0,0
1920,3,1,H,1,1,2691,1,1,3,4,0,4,6,6,4,4,0,0,-1,0,0,0,0
1920,0,1,A,1,1,2692,1,1,3,3,0,3,4,5,4,2,-2,-1,0,0,0,0,0
1920,2,1,H,2,1,2693,2,1,7,4,1,4,2,2,3,5,2,0,3,0,0,0,0
1920,0,2,A,2,3,2694,2,3,6,9,0,9,7,1,1,2,1,6,-3,0,0,0,1
1920,3,0,H,1,1,2695,1,1,3,3,0,3,4,5,7,7,0,-1,0,0,0,0,0
1920,1,2,A,2,1,2696,2,1,7,5,1,5,8,6,4,6,2,2,2,0,0,0,0
1920,1,4,A,1,2,2697,1,2,3,6,0,6,9,7,6,2,-4,2,-3,0,0,0,0
1920,1,0,H,0,2,2698,0,2,0,6,0,6,6,5,9,1,-8,1,-6,0,0,0,0
1920,2,2,D,2,0,2699,2,0,6,1,0,1,4,6,6,7,1,-2,5,0,0,0,0
1920,2,0,H,1,1,2700,1,1,4,3,1,3,4,5,3,5,2,-1,1,0,0,0,0
1920,0,0,D,1,1,2701,1,1,4,3,1,3,2,5,4,3,-1,-3,1,0,0,0,0
1920,1,2,A,2,3,2702,1,2,6,10,0,10,7,4,5,5,0,3,-4,0,0,0,0
1920,0,2,A,2,2,2703,1,2,8,7,2,7,9,8,7,10,3,1,1,0,0,0,0
1920,2,1,H,0,1,2704,0,0,2,3,2,3,2,9,8,6,-2,-7,-1,0,0,0,0
1920,0,0,D,1,2,2705,1,2,4,7,1,7,7,6,9,7,-2,1,-3,0,0,0,0
1920,1,0,H,4,2,2706,3,1,12,7,0,7,7,3,1,9,8,4,5,0,0,1,0
1920,0,1,A,3,2,2707,2,1,9,6,0,6,7,5,8,13,5,2,3,0,0,0,0
1920,1,0,H,1,2,2708,1,1,3,6,0,6,10,7,7,4,-3,3,-3,0,0,0,0
1920,1,3,A,1,1,2709,1,1,3,3,0,3,3,10,8,4,-4,-7,0,0,0,0,0
1920,2,1,H,2,2,2710,2,2,6,6,0,6,2,3,6,6,0,-1,0,0,0,0,0
1920,2,0,H,4,1,2711,2,1,13,3,1,3,5,11,5,9,4,-6,10,0,0,0,0
1920,1,3,A,1,5,2712,0,3,3,15,0,15,10,1,11,3,-8,9,-12,0,1,0,1
1920,1,4,A,2,3,2713,1,2,6,10,0,10,11,8,8,10,2,3,-4,0,0,0,0
1920,2,1,H,3,2,2714,2,1,9,6,0,6,6,7,9,13,4,-1,3,0,0,0,0
1920,4,0,H,2,1,2715,1,1,7,5,1,5,7,9,4,7,3,-2,2,0,0,0,0
1920,0,1,A,2,2,2716,1,1,6,8,0,8,10,9,11,6,-5,1,-2,0,0,0,0
1920,1,0,H,1,2,2717,1,2,4,8,1,8,7,6,5,2,-3,1,-4,0,0,0,0
1920,1,1,D,3,1,2718,1,1,9,5,0,5,3,4,5,8,3,-1,4,0,0,0,0
1920,1,3,A,2,1,2719,2,0,6,5,0,5,8,9,5,3,-2,-1,1,0,0,0,0
1920,3,2,H,2,3,2720,1,2,6,9,0,9,8,7,7,5,-2,1,-3,0,0,0,0
1920,1,0,H,1,2,2721,1,1,3,9,0,6,8,9,13,5,-8,-1,-6,0,0,0,0
1920,2,0,H,1,1,2722,1,0,6,3,2,3,4,14,5,4,-1,-10,3,0,0,0,0
1920,1,2,A,1,2,2723,1,2,5,6,2,6,4,8,13,7,-6,-4,-1,0,0,0,0
1920,1,0,H,1,1,2724,0,1,8,7,2,4,3,5,10,11,1,-2,1,0,0,0,0
1920,3,1,H,3,2,2725,2,1,13,6,1,6,6,12,9,15,6,-6,7,0,0,0,0
1920,2,2,D,2,2,2726,2,1,8,10,2,7,11,4,7,7,0,7,-2,0,0,0,0
1920,1,1,D,2,3,2727,1,1,11,10,2,9,9,6,9,11,2,3,1,0,0,0,0
1920,0,0,D,3,3,2728,2,2,9,12,0,9,15,10,10,10,0,5,-3,0,0,0,0
1920,1,2,A,5,4,2729,3,2,18,16,0,13,11,5,2,13,11,6,2,1,0,1,0
1920,3,3,D,2,3,2730,1,2,11,16,1,10,18,10,6,13,7,8,-5,0,0,0,0
1920,2,0,H,3,1,2731,2,1,13,9,0,5,6,5,10,15,5,1,4,0,0,0,0
1920,2,1,H,4,2,2732,2,2,19,9,1,8,9,9,6,13,7,0,10,0,0,0,0
1920,3,4,A,2,5,2733,1,3,6,18,0,15,14,4,12,11,-1,10,-12,0,1,0,1
1920,2,0,H,3,1,2734,1,1,11,6,0,3,6,13,7,10,3,-7,5,0,0,0,0
1920,0,0,D,1,2,2735,0,1,3,12,0,8,12,10,16,4,-12,2,-9,0,0,0,0
1920,1,0,H,1,3,2736,1,2,7,10,1,9,10,10,6,3,-3,0,-3,0,0,0,0
1920,5,1,H,2,1,2737,1,1,9,5,0,5,8,15,10,8,-2,-7,4,0,0,0,0
1920,2,2,D,2,2,2738,2,1,9,6,0,6,7,15,9,6,-3,-8,3,0,0,0,0
1920,0,0,D,2,1,2739,1,0,6,11,0,5,12,10,9,7,-2,2,-5,0,0,0,0
1920,0,1,A,1,2,2740,1,1,9,6,2,6,14,16,7,6,-1,-2,3,0,0,0,0
1920,1,1,D,2,4,2741,1,2,7,22,0,13,15,7,17,9,-8,8,-15,0,0,0,0
1920,2,2,D,5,2,2742,3,1,21,12,0,6,13,11,7,18,11,2,9,1,0,1,0
1920,3,1,H,1,2,2743,1,1,5,7,2,6,7,9,20,9,-11,-2,-2,0,0,0,0
1920,2,1,H,2,1,2744,2,0,9,4,2,3,4,16,11,10,-1,-12,5,0,0,0,0
1920,7,1,H,3,1,2745,2,1,17,10,1,4,4,6,13,21,8,-2,7,0,0,0,0
1920,1,1,D,1,3,2746,1,2,6,16,0,9,17,10,15,6,-9,7,-10,0,0,0,0
1920,1,1,D,3,3,2747,2,1,10,14,0,9,12,7,11,10,-1,5,-4,0,0,0,0
1920,2,1,H,2,2,2748,1,2,13,10,2,6,8,11,10,12,2,-3,3,0,0,0,0
1920,1,2,A,1,2,2749,0,1,12,12,2,7,16,9,10,12,2,7,0,0,0,0,0
1920,0,1,A,2,1,2750,1,1,13,9,0,5,6,8,13,15,2,-2,4,0,0,0,0
1920,1,2,A,2,5,2751,1,3,7,22,0,15,20,9,12,8,-4,11,-15,0,1,0,1
1920,2,2,D,3,3,2752,2,2,17,20,0,10,28,14,11,18,7,14,-3,0,0,0,0
1920,3,2,H,3,2,2753,1,2,15,12,0,8,12,12,8,13,5,0,3,0,0,0,0
1920,2,1,H,4,1,2754,2,1,23,8,1,5,12,21,8,16,8,-9,15,0,0,0,0
1920,4,0,H,2,3,2755,1,2,15,11,1,9,11,12,10,18,8,-1,4,0,0,0,0
1920,1,1,D,1,2,2756,0,1,4,8,0,6,10,18,18,5,-13,-8,-4,0,0,0,0
1920,1,2,A,2,1,2757,1,0,9,12,0,5,13,12,16,15,-1,1,-3,0,0,0,0
1920,0,4,A,1,2,2758,1,1,10,16,1,8,14,11,13,5,-8,3,-6,0,0,0,0
1920,1,0,H,2,1,2759,2,1,10,7,0,3,7,16,13,9,-4,-9,3,0,0,0,0
1920,2,1,H,2,3,2760,1,2,19,18,2,9,20,13,11,18,7,7,1,0,0,0,0
1920,1,2,A,2,5,2761,2,3,12,25,2,15,22,10,15,14,-1,12,-13,0,1,0,1
1920,0,1,A,3,4,2762,2,2,11,26,0,13,18,9,16,11,-5,9,-15,0,0,0,0
1920,0,2,A,3,3,2763,2,1,21,18,1,9,16,10,16,30,14,6,3,0,0,0,0
1920,1,3,A,1,1,2764,1,1,8,10,2,4,5,17,23,13,-10,-12,-2,0,0,0,0
1920,2,2,D,2,2,2765,1,1,9,9,0,6,16,18,19,11,-8,-2,0,0,0,0,0
1920,2,1,H,1,2,2766,1,1,12,7,2,6,9,14,8,7,-1,-5,5,0,0,0,0
1920,1,1,D,1,2,2767,0,1,15,13,2,6,15,14,13,15,2,1,2,0,0,0,0
1920,1,2,A,2,2,2768,2,1,13,18,0,7,22,10,13,10,-3,12,-5,0,0,0,0
1920,0,1,A,1,1,2769,1,0,7,5,0,3,6,19,17,7,-10,-13,2,0,0,0,0
1920,3,1,H,2,2,2770,1,2,10,12,0,8,15,17,20,18,-2,-2,-2,0,0,0,0
1920,0,4,A,2,3,2771,1,2,7,11,0,9,11,17,16,10,-6,-6,-4,0,0,0,0
1920,2,1,H,5,1,2772,3,1,28,15,0,5,9,9,11,24,13,0,13,1,0,1,0
1920,0,0,D,3,1,2773,2,1,18,8,0,5,14,26,15,21,6,-12,10,0,0,0,0
1920,5,2,H,3,1,2774,1,0,21,16,0,5,16,14,10,18,8,2,5,0,0,0,0
1920,4,2,H,2,2,2775,1,1,21,10,1,6,13,21,11,24,13,-8,11,0,0,0,0
1920,0,0,D,1,3,2776,0,2,8,21,0,10,30,18,19,7,-12,12,-13,0,0,0,0
1920,0,0,D,1,1,2777,1,1,13,7,1,3,7,18,18,8,-10,-11,6,0,0,0,0
1920,2,0,H,2,2,2778,1,1,14,22,0,8,20,12,15,16,1,8,-8,0,0,0,0
1920,1,0,H,4,2,2779,2,2,29,13,1,6,11,15,9,19,10,-4,16,0,0,0,0
1920,1,3,A,3,4,2780,2,2,22,32,1,13,20,9,18,30,12,11,-10,0,0,0,0
1920,1,1,D,2,3,2781,2,2,13,19,0,9,21,15,16,11,-5,6,-6,0,0,0,0
1920,0,3,A,3,5,2782,2,3,14,31,0,15,26,12,17,15,-2,14,-17,0,1,0,1
1920,2,2,D,2,2,2783,2,1,12,17,2,6,18,15,20,16,-4,3,-5,0,0,0,0
1920,3,0,H,2,2,2784,1,1,22,7,2,6,10,20,14,20,6,-10,15,0,0,0,0
1920,1,2,A,2,2,2785,1,1,13,24,0,7,28,13,21,21,0,15,-11,0,0,0,0
1920,1,0,H,1,1,2786,1,0,15,16,2,5,18,19,11,10,-1,-1,-1,0,0,0,0
1920,2,1,H,1,1,2787,0,1,9,14,0,4,8,18,19,7,-12,-10,-5,0,0,0,0
1920,2,2,D,2,3,2788,1,1,10,24,0,9,23,12,25,15,-10,11,-14,0,0,0,0
1920,1,1,D,1,1,2789,1,1,8,9,0,5,14,26,18,7,-11,-12,-1,0,0,0,0
1920,0,3,A,2,3,2790,1,2,7,22,0,10,31,21,23,10,-13,10,-15,0,0,0,0
1920,0,1,A,1,3,2791,1,2,10,14,2,9,15,20,27,15,-12,-5,-4,0,0,0,0
1920,0,1,A,1,2,2792,0,1,16,11,2,6,17,27,20,18,-2,-10,5,0,0,0,0
1920,2,2,D,4,2,2793,2,1,35,13,1,6,22,23,10,23,13,-1,22,0,0,0,0
1920,2,1,H,5,1,2794,3,1,34,9,0,3,8,19,12,29,17,-11,25,1,0,1,0
1920,3,0,H,2,1,2795,1,1,27,14,1,4,9,20,14,30,16,-11,13,0,0,0,0
1920,0,1,A,2,2,2796,1,2,18,14,0,6,12,17,17,20,3,-5,4,0,0,0,0
1920,1,2,A,3,2,2797,2,2,20,13,0,8,18,22,16,22,6,-4,7,0,0,0,0
1920,1,3,A,1,2,2798,1,1,18,25,2,8,23,14,11,11,0,9,-7,0,0,0,0
1920,4,3,H,3,1,2799,1,0,25,12,0,3,9,20,14,25,11,-11,13,0,0,0,0
1920,0,0,D,5,2,2800,3,1,37,28,0,8,26,15,13,31,18,11,9,1,0,1,0
1920,3,2,H,3,1,2801,2,1,25,18,1,5,12,14,21,34,13,-2,7,0,0,0,0
1920,1,1,D,1,3,2802,1,2,14,20,1,9,23,18,23,9,-14,5,-6,0,0,0,0
1920,3,1,H,2,4,2803,1,2,30,36,1,13,25,12,14,33,19,13,-6,0,0,0,0
1920,2,2,D,2,1,2804,1,1,14,10,0,5,15,28,27,18,-9,-13,4,0,0,0,0
1920,2,2,D,2,3,2805,1,1,14,28,0,9,29,17,25,24,-1,12,-14,0,0,0,0
1920,0,1,A,1,2,2806,1,1,9,7,0,6,10,26,21,9,-12,-16,2,0,0,0,0
1920,2,1,H,3,1,2807,2,0,17,16,0,5,18,21,20,16,-4,-3,1,0,0,0,0
1920,0,1,A,1,2,2808,0,1,12,18,0,6,20,18,24,12,-12,2,-6,0,0,0,0
1920,2,3,A,2,2,2809,2,2,16,17,2,6,13,17,23,20,-3,-4,-1,0,0,0,0
1920,3,0,H,2,2,2810,1,1,10,15,0,6,20,29,26,11,-15,-9,-5,0,0,0,0
1920,1,2,A,3,2,2811,2,1,21,21,0,6,21,18,19,24,5,3,0,0,0,0,0
1920,0,1,A,1,1,2812,1,0,11,12,2,3,12,25,30,17,-13,-13,-1,0,0,0,0
1920,3,3,D,1,3,2813,1,2,18,20,2,9,18,21,17,14,-3,-3,-2,0,0,0,0
1920,2,1,H,2,3,2814,2,2,16,28,2,10,37,23,26,22,-4,14,-12,0,0,0,0
1920,3,1,H,4,1,2815,2,1,36,15,1,4,10,24,15,26,11,-14,21,0,0,0,0
1920,0,0,D,2,2,2816,2,1,20,15,0,6,26,27,19,16,-3,-1,5,0,0,0,0
1920,3,1,H,2,1,2817,1,1,29,9,2,3,9,22,15,26,11,-13,20,0,0,0,0
1920,1,1,D,1,5,2818,0,3,16,38,2,15,31,13,23,19,-4,18,-22,0,1,0,1
1920,1,2,A,3,2,2819,1,1,29,33,0,7,36,15,19,31,12,21,-4,0,0,0,0
1920,1,2,A,1,4,2820,0,2,15,39,0,13,29,16,25,13,-12,13,-24,0,0,0,0
1920,0,2,A,2,2,2821,1,1,13,16,0,6,26,27,26,14,-12,-1,-3,0,0,0,0
1920,1,4,A,1,2,2822,0,1,17,32,2,8,29,16,24,20,-4,13,-15,0,0,0,0
1920,2,1,H,1,3,2823,1,1,15,29,1,9,32,21,27,11,-16,11,-14,0,0,0,0
1920,4,0,H,5,1,2824,3,1,39,11,0,5,17,31,14,32,18,-14,28,1,0,1,0
1920,1,2,A,3,1,2825,2,1,21,9,0,3,10,25,24,21,-3,-15,12,0,0,0,0
1920,5,0,H,3,2,2826,2,2,28,21,1,6,16,19,25,38,13,-3,7,0,0,0,0
1920,2,3,A,2,2,2827,1,2,15,19,0,8,24,27,32,20,-12,-3,-4,0,0,0,0
1920,1,1,D,2,2,2828,1,1,24,13,0,6,14,28,19,23,4,-14,11,0,0,0,0
1920,1,2,A,2,3,2829,1,2,19,21,0,9,25,21,27,28,1,4,-2,0,0,0,0
1920,1,2,A,2,2,2830,1,1,14,36,0,7,38,16,29,15,-14,22,-22,0,0,0,0
1920,0,2,A,1,1,2831,1,1,12,19,0,5,17,20,26,12,-14,-3,-7,0,0,0,0
1920,2,1,H,1,2,2832,1,1,11,19,2,6,29,29,35,17,-18,0,-8,0,0,0,0
1920,0,2,A,2,3,2833,1,2,35,21,2,9,22,26,17,33,16,-4,14,0,0,0,0
1920,1,1,D,2,1,2834,2,0,22,17,2,5,21,28,29,27,-2,-7,5,0,0,0,0
1920,5,0,H,3,2,2835,2,1,31,25,1,6,24,20,25,43,18,4,6,0,0,0,0
1920,4,0,H,4,3,2836,2,1,42,29,1,9,33,23,17,31,14,10,13,0,0,0,0
1920,0,0,D,2,1,2837,2,0,21,15,0,3,14,27,24,16,-8,-13,6,0,0,0,0
1920,0,1,A,2,1,2838,1,1,15,18,0,4,13,28,35,22,-13,-15,-3,0,0,0,0
1920,1,3,A,3,5,2839,2,3,24,42,0,15,36,14,22,27,5,22,-18,0,1,0,1
1920,0,2,A,3,2,2840,1,2,29,22,0,6,16,24,27,33,6,-8,7,0,0,0,0
1920,1,0,H,2,3,2841,1,2,39,24,1,9,28,25,17,40,23,3,15,0,0,0,0
1920,1,1,D,5,3,2842,3,2,45,34,0,10,48,25,15,39,24,23,11,1,0,1,0
1920,3,0,H,1,2,2843,1,1,21,19,1,6,30,31,28,14,-14,-1,2,0,0,0,0
1920,1,0,H,1,1,2844,0,1,18,12,2,3,12,28,29,22,-7,-16,6,0,0,0,0
1920,5,1,H,1,2,2845,0,1,16,14,0,6,16,31,27,14,-13,-15,2,0,0,0,0
1920,1,0,H,3,2,2846,2,2,24,23,0,8,28,30,26,24,-2,-2,1,0,0,0,0
1920,2,1,H,1,1,2847,1,1,22,14,2,5,19,36,20,19,-1,-17,8,0,0,0,0
1920,1,2,A,2,4,2848,1,2,35,45,2,13,35,17,19,33,14,18,-10,0,0,0,0
1920,2,0,H,2,2,2849,1,1,25,15,0,6,22,36,25,24,-1,-14,10,0,0,0,0
1920,5,1,H,2,1,2850,1,0,42,19,1,3,19,28,17,41,24,-9,23,0,0,0,0
1920,2,1,H,2,3,2851,1,2,19,27,3,9,25,26,34,30,-4,-1,-8,0,0,0,0
1920,0,2,A,3,1,2852,2,0,24,21,0,5,23,29,26,28,2,-6,3,0,0,0,0
1920,3,2,H,2,1,2853,2,1,25,24,3,4,17,28,24,18,-6,-11,1,0,0,0,0
1920,1,1,D,2,1,2854,2,1,23,25,2,5,21,21,31,28,-3,0,-2,0,0,0,0
1920,2,2,D,2,3,2855,1,1,14,29,0,9,33,29,36,17,-19,4,-15,0,0,0,0
1920,1,1,D,2,5,2856,1,3,15,46,3,15,40,16,38,22,-16,24,-31,0,1,0,1
1920,1,3,A,1,2,2857,1,1,14,35,2,8,34,21,38,20,-18,13,-21,0,0,0,0
1920,2,1,H,4,2,2858,2,1,48,28,1,6,26,25,18,37,19,1,20,0,0,0,0
1920,1,2,A,3,1,2859,2,1,35,12,1,3,12,29,26,49,23,-17,23,0,0,0,0
1920,0,1,A,2,2,2860,1,2,15,28,3,6,21,26,38,19,-19,-5,-13,0,0,0,0
1920,1,3,A,1,2,2861,1,2,15,24,3,8,29,32,30,14,-16,-3,-9,0,0,0,0
1920,0,0,D,1,1,2862,0,1,24,14,5,5,21,41,29,25,-4,-20,10,0,0,0,0
1920,0,7,A,3,3,2863,2,2,27,35,0,10,50,28,28,26,-2,22,-8,0,0,0,0
1920,1,1,D,5,3,2864,3,1,47,30,0,9,35,31,17,41,24,4,17,1,0,1,0
1920,2,0,H,2,1,2865,1,1,28,24,0,4,19,31,27,27,0,-12,4,0,0,0,0
1920,0,0,D,1,2,2866,0,1,19,22,3,6,32,35,33,20,-13,-3,-3,0,0,0,0
1920,3,0,H,1,2,2867,1,1,26,16,2,6,23,39,22,22,0,-16,10,0,0,0,0
1920,1,1,D,2,2,2868,1,1,38,45,2,7,46,18,22,37,15,28,-7,0,0,0,0
1920,2,1,H,3,4,2869,2,2,24,51,3,13,39,19,28,28,0,20,-27,0,0,0,0
1920,2,1,H,2,2,2870,2,1,27,15,2,6,19,39,33,32,-1,-20,12,0,0,0,0
1920,2,2,D,3,2,2871,1,1,31,31,0,6,29,27,32,36,4,2,0,0,0,0,0
1920,4,2,H,2,2,2872,1,1,23,39,3,8,38,23,35,32,-3,15,-16,0,0,0,0
1920,3,0,H,4,1,2873,2,0,51,25,1,5,25,29,21,40,19,-4,26,0,0,0,0
1920,2,2,D,3,1,2874,2,1,38,15,1,5,21,41,28,57,29,-20,23,0,0,0,0
1920,5,1,H,2,1,2875,1,1,46,15,4,3,15,33,19,47,28,-18,31,0,0,0,0
1920,1,1,D,2,1,2876,2,1,31,29,0,5,25,22,26,22,-4,3,2,0,0,0,0
1920,4,0,H,2,3,2877,1,2,16,27,0,9,26,35,42,23,-19,-9,-11,0,0,0,0
1920,0,2,A,1,5,2878,1,3,24,48,4,15,42,18,33,19,-14,24,-24,0,1,0,1
1920,2,4,A,1,3,2879,0,2,20,27,3,9,30,29,33,20,-13,1,-7,0,0,0,0
1920,0,0,D,2,1,2880,1,1,49,30,1,5,26,23,20,52,32,3,19,0,0,0,0
1920,2,3,A,2,2,2881,1,2,39,30,2,8,34,34,27,40,13,0,9,0,0,0,0
1920,1,2,A,1,3,2882,0,2,25,39,2,10,59,30,32,25,-7,29,-14,0,0,0,0
1920,1,3,A,3,1,2883,2,0,27,20,3,3,22,37,39,26,-13,-15,7,0,0,0,0
1920,2,1,H,1,4,2884,1,2,31,54,5,13,43,21,23,26,3,22,-23,0,0,0,0
1920,1,2,A,1,2,2885,1,1,15,26,3,6,36,37,38,16,-22,-1,-11,0,0,0,0
1920,1,1,D,2,1,2886,1,1,15,24,0,4,19,35,41,20,-21,-16,-9,0,0,0,0
1920,1,0,H,1,3,2887,1,1,16,32,5,9,38,34,43,23,-20,4,-16,0,0,0,0
1920,2,3,A,3,2,2888,2,1,30,19,0,6,27,42,31,34,3,-15,11,0,0,0,0
1920,0,1,A,2,2,2889,1,1,32,50,3,7,52,20,29,31,2,32,-18,0,0,0,0
1920,4,2,H,5,2,2890,3,2,51,32,0,6,23,27,18,44,26,-4,19,1,0,1,0
1920,2,1,H,2,1,2891,1,1,22,15,0,3,17,40,44,30,-14,-23,7,0,0,0,0
1920,0,3,A,2,1,2892,2,1,33,19,2,5,24,43,36,37,1,-19,14,0,0,0,0
1920,2,1,H,3,2,2893,2,1,42,39,1,8,42,30,31,61,30,12,3,0,0,0,0
1920,0,0,D,1,1,2894,1,1,25,34,1,5,28,24,36,20,-16,4,-9,0,0,0,0
1920,2,0,H,4,2,2895,2,1,54,16,1,6,21,42,23,44,21,-21,38,0,0,0,0
1920,1,5,A,1,1,2896,0,0,23,25,3,5,26,34,38,25,-13,-8,-2,0,0,0,0
1920,0,1,A,2,2,2897,1,1,29,32,3,6,31,30,38,38,0,1,-3,0,0,0,0
1920,0,1,A,3,3,2898,1,2,32,30,0,9,36,34,35,38,3,2,2,0,0,0,0
1920,2,1,H,2,5,2899,1,3,53,54,4,15,48,20,20,53,33,28,-1,0,1,0,1
1920,1,0,H,2,3,2900,2,2,32,27,3,9,27,42,31,25,-6,-15,5,0,0,0,0
1920,1,2,A,2,3,2901,1,2,16,33,0,9,37,34,44,21,-23,3,-17,0,0,0,0
1920,1,1,D,2,1,2902,2,1,33,26,2,4,20,36,39,37,-2,-16,7,0,0,0,0
1920,1,2,A,1,4,2903,1,2,15,57,0,13,46,23,42,18,-24,23,-42,0,0,0,0
1920,1,1,D,1,2,2904,0,2,28,35,2,6,26,31,35,31,-4,-5,-7,0,0,0,0
1920,2,3,A,1,2,2905,1,1,22,56,2,7,55,21,43,27,-16,34,-34,0,0,0,0
1920,4,0,H,2,2,2906,1,1,39,25,2,6,32,45,32,43,11,-13,14,0,0,0,0
1920,2,0,H,2,2,2907,1,2,59,34,1,8,38,40,23,58,35,-2,25,0,0,0,0
1920,2,1,H,3,3,2908,2,2,36,27,0,9,27,43,35,39,4,-16,9,0,0,0,0
1920,2,7,A,2,3,2909,1,2,25,45,0,10,63,32,49,32,-17,31,-20,0,0,0,0
1920,3,4,A,3,2,2910,1,1,32,42,0,8,47,32,36,38,2,15,-10,0,0,0,0
1920,0,1,A,2,1,2911,1,1,35,15,0,3,19,44,30,32,2,-25,20,0,0,0,0
1920,1,2,A,2,1,2912,2,1,36,22,0,5,29,46,32,27,-5,-17,14,0,0,0,0
1920,2,1,H,1,1,2913,0,1,23,35,0,5,28,24,43,26,-17,4,-12,0,0,0,0
1920,0,0,D,1,1,2914,1,0,27,29,1,5,32,36,37,21,-16,-4,-2,0,0,0,0
1920,2,0,H,4,5,2915,2,3,60,54,1,15,49,22,24,48,24,27,6,0,1,0,1
1920,3,0,H,2,2,2916,1,1,29,16,0,6,22,46,39,38,-1,-24,13,0,0,0,0
1920,1,1,D,3,2,2917,2,1,27,35,0,6,32,31,45,28,-17,1,-8,0,0,0,0
1920,2,1,H,1,3,2918,1,1,35,32,2,9,41,40,26,29,3,1,3,0,0,0,0
1920,4,1,H,3,2,2919,2,1,48,32,1,6,41,39,34,70,36,2,16,0,0,0,0
1920,2,1,H,5,1,2920,3,0,54,26,0,3,28,44,24,49,25,-16,28,1,0,1,0
1920,1,1,D,1,2,2921,0,1,30,16,2,6,22,49,36,32,-4,-27,14,0,0,0,0
1920,1,4,A,2,2,2922,1,2,25,36,0,6,28,34,56,34,-22,-6,-11,0,0,0,0
1920,0,2,A,2,4,2923,2,2,34,63,2,13,50,24,42,38,-4,26,-29,0,0,0,0
1920,0,1,A,1,3,2924,1,1,18,32,0,9,42,42,44,20,-24,0,-14,0,0,0,0
1920,0,2,A,1,3,2925,1,2,38,39,2,9,41,36,27,31,4,5,-1,0,0,0,0
1920,1,4,A,1,2,2926,1,1,25,36,2,6,33,32,47,31,-16,1,-11,0,0,0,0
1920,1,0,H,3,1,2927,2,1,28,28,0,4,21,37,46,29,-17,-16,0,0,0,0,0
1920,3,3,D,5,2,2928,3,1,57,32,0,6,42,43,25,51,26,-1,25,1,0,1,0
1920,3,2,H,3,2,2929,2,1,51,62,1,7,60,23,35,74,39,37,-11,0,0,0,0
1920,2,1,H,2,1,2930,1,0,45,26,2,3,29,46,35,51,16,-17,19,0,0,0,0
1920,4,0,H,4,2,2931,2,1,66,25,1,6,35,60,24,52,28,-25,41,0,0,0,0
1920,2,2,D,2,1,2932,1,1,17,25,0,5,32,51,50,23,-27,-19,-8,0,0,0,0
1920,4,2,H,3,3,2933,1,2,35,31,0,9,30,46,42,43,1,-16,4,0,0,0,0
1920,2,1,H,2,1,2934,1,0,62,31,1,5,33,37,26,62,36,-4,31,0,0,0,0
1920,2,0,H,2,2,2935,2,1,39,48,0,8,53,36,35,32,-3,17,-9,0,0,0,0
1920,3,1,H,3,1,2936,2,1,42,18,0,3,20,45,36,43,7,-25,24,0,0,0,0
1920,1,2,A,1,2,2937,0,2,26,34,0,8,38,44,48,30,-18,-6,-8,0,0,0,0
1920,3,3,D,2,1,2938,1,1,33,38,0,5,31,29,46,45,-1,2,-5,0,0,0,0
1920,2,3,A,1,3,2939,1,2,28,54,1,10,77,37,38,21,-17,40,-26,0,0,0,0
1920,1,2,A,2,5,2940,1,3,39,58,0,15,54,28,33,37,4,26,-19,0,1,0,1
1920,1,2,A,3,2,2941,2,1,31,65,0,7,64,27,50,32,-18,37,-34,0,0,0,0
1920,1,3,A,1,4,2942,1,2,26,69,2,13,56,24,53,34,-19,32,-43,0,0,0,0
1920,1,1,D,2,3,2943,2,1,37,38,2,9,47,44,45,40,-5,3,-1,0,0,0,0
1920,6,0,H,5,2,2944,3,1,61,18,0,6,25,52,29,56,27,-27,43,1,0,1,0
1920,1,3,A,1,2,2945,0,1,31,34,2,6,48,49,39,34,-5,-1,-3,0,0,0,0
1920,1,2,A,2,1,2946,1,0,25,26,0,3,31,50,64,35,-29,-19,-1,0,0,0,0
1920,2,2,D,1,2,2947,1,2,18,42,0,6,34,35,48,21,-27,-1,-24,0,0,0,0
1920,3,2,H,1,2,2948,1,1,39,39,2,6,38,35,32,34,2,3,0,0,0,0,0
1920,2,0,H,3,3,2949,2,2,57,45,1,9,46,37,39,80,41,9,12,0,0,0,0
1920,0,2,A,2,1,2950,1,1,48,28,2,4,23,41,38,53,15,-18,20,0,0,0,0
1920,4,1,H,4,3,2951,2,2,72,31,1,9,33,52,25,59,34,-19,41,0,0,0,0
1920,4,2,H,2,2,2952,1,1,37,25,0,6,36,66,50,51,1,-30,12,0,0,0,0
1920,0,3,A,2,2,2953,1,2,68,43,1,6,36,37,28,66,38,-1,25,0,0,0,0
1920,1,2,A,5,2,2954,3,2,64,38,0,8,41,46,29,62,33,-5,26,1,0,1,0
1920,2,0,H,2,1,2955,1,1,18,42,0,5,37,34,58,25,-33,3,-24,0,0,0,0
1920,0,1,A,3,3,2956,1,2,39,60,0,10,82,39,45,48,3,43,-21,0,0,0,0
1920,1,2,A,2,1,2957,1,0,39,31,0,5,35,42,38,40,2,-7,8,0,0,0,0
1920,3,0,H,1,1,2958,0,1,29,19,0,3,23,50,51,33,-18,-27,10,0,0,0,0
1920,2,2,D,1,1,2959,1,1,31,26,1,5,35,56,41,25,-16,-21,5,0,0,0,0
1920,2,1,H,3,2,2960,2,1,45,48,0,8,53,40,39,46,7,13,-3,0,0,0,0
1920,2,1,H,2,2,2961,1,1,25,68,0,7,66,31,70,38,-32,35,-43,0,0,0,0
1920,4,2,H,2,4,2962,2,2,46,75,0,13,63,26,37,39,2,37,-29,0,0,0,0
1920,0,0,D,1,3,2963,0,1,34,39,2,9,48,46,43,37,-6,2,-5,0,0,0,0
1920,1,2,A,1,3,2964,1,2,27,48,2,9,48,40,58,37,-21,8,-21,0,0,0,0
1920,2,0,H,3,1,2965,2,0,63,32,1,3,36,51,39,83,44,-15,31,0,0,0,0
1920,1,2,A,2,2,2966,2,1,41,40,2,6,55,52,47,43,-4,3,1,0,0,0,0
1920,2,1,H,2,2,2967,1,1,48,39,2,6,41,40,42,54,12,1,9,0,0,0,0
1920,3,1,H,3,2,2968,2,1,31,21,0,6,27,58,56,34,-22,-31,10,0,0,0,0
1920,0,3,A,1,1,2969,1,1,19,32,0,4,27,43,53,23,-30,-16,-13,0,0,0,0
1920,2,2,D,1,5,2970,1,3,42,64,2,15,63,31,36,37,1,32,-22,0,1,0,1
1920,1,2,A,2,2,2971,1,1,68,43,1,6,57,53,33,67,34,4,25,0,0,0,0
1920,0,3,A,2,2,2972,1,1,21,51,0,8,56,43,61,28,-33,13,-30,0,0,0,0
1920,2,2,D,4,3,2973,2,2,75,66,1,10,85,39,30,65,35,46,9,0,0,0,0
1920,2,0,H,1,1,2974,1,1,27,19,2,3,23,56,60,38,-22,-33,8,0,0,0,0
1920,0,0,D,3,2,2975,1,1,40,28,0,6,40,71,46,48,2,-31,12,0,0,0,0
1920,1,1,D,1,1,2976,0,1,35,43,2,5,39,38,43,37,-6,1,-8,0,0,0,0
1920,2,2,D,2,2,2977,1,2,39,41,0,8,44,49,42,42,0,-5,-2,0,0,0,0
1920,1,3,A,1,1,2978,1,0,35,32,1,3,36,53,43,30,-13,-17,3,0,0,0,0
1920,2,2,D,3,2,2979,2,2,51,49,0,6,43,39,41,50,9,4,2,0,0,0,0
1920,3,1,H,5,3,2980,3,2,65,34,0,9,37,57,33,65,32,-20,31,1,0,1,0
1920,6,2,H,3,2,2981,2,1,67,21,1,6,28,64,41,87,46,-36,46,0,0,0,0
1920,1,1,D,2,3,2982,2,2,42,52,2,9,52,43,51,46,-5,9,-10,0,0,0,0
1920,3,1,H,2,2,2983,2,1,50,40,0,6,44,44,41,45,4,0,10,0,0,0,0
1920,3,0,H,1,3,2984,0,1,35,41,0,9,48,46,54,39,-15,2,-6,0,0,0,0
1920,1,3,A,2,1,2985,1,0,29,36,0,5,38,44,71,40,-31,-6,-7,0,0,0,0
1920,2,1,H,2,1,2986,1,1,54,44,2,5,40,39,43,59,16,1,10,0,0,0,0
1920,3,3,D,2,4,2987,1,2,46,76,0,13,67,32,54,59,5,35,-30,0,0,0,0
1920,0,0,D,1,2,2988,1,1,35,68,1,7,68,35,46,31,-15,33,-33,0,0,0,0
1920,3,0,H,3,1,2989,2,1,34,30,0,5,40,60,60,38,-22,-20,4,0,0,0,0
1920,0,4,A,1,5,2990,1,3,19,68,0,15,68,34,58,23,-35,34,-49,0,1,0,1
1920,1,1,D,1,3,2991,1,2,44,70,2,10,93,43,41,41,0,50,-26,0,0,0,0
1920,1,1,D,3,2,2992,1,1,41,47,0,6,62,57,49,48,-1,5,-6,0,0,0,0
1920,5,1,H,2,2,2993,2,2,53,43,0,8,47,52,42,48,6,-5,10,0,0,0,0
1920,2,3,A,2,1,2994,1,0,40,38,0,3,42,54,47,45,-2,-12,2,0,0,0,0
1920,2,1,H,2,1,2995,1,1,21,19,0,3,23,62,70,30,-40,-39,2,0,0,0,0
1920,2,0,H,1,3,2996,0,2,39,37,2,9,41,60,45,41,-4,-19,2,0,0,0,0
1920,2,1,H,1,2,2997,1,1,30,29,2,6,41,74,63,40,-23,-33,1,0,0,0,0
1920,2,1,H,3,1,2998,2,1,53,36,0,4,31,46,44,53,9,-15,17,0,0,0,0
1920,2,2,D,2,5,2999,1,3,57,71,2,15,72,34,44,61,17,38,-14,0,1,0,1
1920,2,1,H,4,2,3000,2,1,77,69,1,7,68,35,35,70,35,33,8,0,0,0,0
1920,1,0,H,3,2,3001,2,2,71,43,1,8,48,57,44,94,50,-9,28,0,0,0,0
1920,1,2,A,2,2,3002,1,2,48,56,0,6,53,43,58,63,5,10,-8,0,0,0,0
1920,2,1,H,2,3,3003,1,2,40,56,0,9,55,45,50,47,-3,10,-16,0,0,0,0
1920,0,0,D,5,1,3004,3,0,72,42,0,5,43,45,36,74,38,-2,30,1,0,1,0
1920,3,1,H,2,2,3005,1,1,29,24,0,6,32,71,76,42,-34,-39,5,0,0,0,0
1920,1,2,A,1,1,3006,0,1,41,33,0,5,42,64,56,45,-11,-22,8,0,0,0,0
1920,1,6,A,1,2,3007,1,1,19,58,0,8,63,46,64,24,-40,17,-39,0,0,0,0
1920,1,1,D,3,1,3008,2,1,37,45,0,5,42,42,62,41,-21,0,-8,0,0,0,0
1920,2,1,H,1,4,3009,1,2,36,80,1,13,72,36,48,32,-16,36,-44,0,0,0,0
1920,2,1,H,2,3,3010,1,1,69,42,1,9,49,50,37,69,32,-1,27,0,0,0,0
1920,1,1,D,2,3,3011,2,2,59,74,0,10,95,44,44,55,11,51,-15,0,0,0,0
1920,1,2,A,2,2,3012,1,1,24,43,0,6,49,51,74,33,-41,-2,-19,0,0,0,0
1920,0,3,A,1,5,3013,1,3,36,73,2,15,74,36,65,44,-21,38,-37,0,1,0,1
1920,2,0,H,3,2,3014,2,1,56,48,0,6,64,60,47,56,9,4,8,0,0,0,0
1920,3,2,H,2,2,3015,2,1,43,32,2,6,45,77,58,48,-10,-32,11,0,0,0,0
1920,0,1,A,3,1,3016,1,1,42,39,0,4,34,49,52,50,-2,-15,3,0,0,0,0
1920,2,1,H,2,1,3017,1,0,61,43,2,5,43,45,47,69,22,-2,18,0,0,0,0
1920,1,1,D,1,3,3018,1,2,19,38,0,9,42,63,70,25,-45,-21,-19,0,0,0,0
1920,1,5,A,1,2,3019,1,1,46,72,2,7,71,38,43,43,0,33,-26,0,0,0,0
1920,2,0,H,4,1,3020,2,0,80,41,1,3,46,58,38,73,35,-12,39,0,0,0,0
1920,1,2,A,2,3,3021,1,2,46,75,0,10,96,45,52,51,-1,51,-29,0,0,0,0
1920,2,0,H,5,3,3022,3,2,76,59,0,9,58,47,36,77,41,11,17,1,0,1,0
1920,2,0,H,2,2,3023,1,1,75,24,1,6,34,76,39,76,37,-42,51,0,0,0,0
1920,1,4,A,1,2,3024,0,2,41,60,0,6,56,45,60,46,-14,11,-19,0,0,0,0
1920,5,0,H,2,1,3025,1,1,48,36,0,5,44,68,62,64,2,-24,12,0,0,0,0
1920,1,2,A,1,2,3026,1,1,42,32,1,6,47,80,49,35,-14,-33,10,0,0,0,0
1920,3,0,H,1,1,3027,1,1,46,20,2,3,26,71,48,44,-4,-45,26,0,0,0,0
1920,2,0,H,3,4,3028,1,2,42,83,0,13,75,38,53,50,-3,37,-41,0,0,0,0
1920,4,0,H,1,2,3029,0,2,43,46,2,8,51,60,47,44,-3,-9,-3,0,0,0,0
1920,2,3,A,3,2,3030,2,1,39,64,0,8,71,48,64,43,-21,23,-25,0,0,0,0
1920,1,1,D,2,1,3031,1,0,24,41,0,3,47,64,78,34,-44,-17,-17,0,0,0,0
1920,0,2,A,3,5,3032,2,3,78,79,1,15,79,36,46,98,52,43,-1,0,1,0,1
1920,1,3,A,4,2,3033,2,1,83,67,1,8,74,50,40,75,35,24,16,0,0,0,0
1920,3,0,H,2,3,3034,2,1,63,45,0,9,52,53,46,60,14,-1,18,0,0,0,0
1920,3,1,H,3,2,3035,2,1,59,78,0,7,78,39,49,58,9,39,-19,0,0,0,0
1920,1,3,A,1,1,3036,1,0,20,46,0,5,48,47,74,26,-48,1,-26,0,0,0,0
1920,1,1,D,2,3,3037,2,2,46,39,2,9,45,67,64,51,-13,-22,7,0,0,0,0
1920,3,0,H,1,1,3038,1,1,36,49,2,5,47,48,73,44,-29,-1,-13,0,0,0,0
1920,3,4,A,2,2,3039,1,1,35,46,0,6,52,54,81,49,-32,-2,-11,0,0,0,0
1920,0,1,A,2,1,3040,1,1,51,42,0,4,36,51,62,69,7,-15,9,0,0,0,0
2021,1,0,H,0,0,3041,0,0,0,0,0,0,0,0,0,0,0,0,0,0,0,0,0
2021,0,0,D,0,0,3042,0,0,0,0,0,0,0,0,0,0,0,0,0,0,0,0,0
2021,0,2,A,0,0,3043,0,0,0,0,0,0,0,0,0,0,0,0,0,0,0,0,0
2021,4,1,H,0,0,3044,0,0,0,0,0,0,0,0,0,0,0,0,0,0,0,0,0
2021,1,1,D,0,0,3045,0,0,0,0,0,0,0,0,0,0,0,0,0,0,0,0,0
2021,3,0,H,0,0,3046,0,0,0,0,0,0,0,0,0,0,0,0,0,0,0,0,0
2021,2,0,H,0,0,3047,0,0,0,0,0,0,0,0,0,0,0,0,0,0,0,0,0
2021,2,4,A,0,0,3048,0,0,0,0,0,0,0,0,1,0,-1,0,0,0,0,0,0
2021,0,2,A,0,0,3049,0,0,1,0,1,0,0,0,1,1,0,0,1,0,0,0,0
2021,2,3,A,0,0,3050,0,0,0,0,0,0,0,0,3,0,-3,0,0,0,0,0,0
2021,4,3,H,0,1,3051,0,1,0,3,0,3,1,0,0,0,0,1,0,0,0,0,0
2021,1,4,A,0,0,3052,0,0,0,1,0,1,1,1,0,0,0,0,0,0,0,0,0
2021,6,0,H,1,1,3053,1,1,3,3,0,3,4,1,0,2,2,3,0,0,0,0,0
2021,1,0,H,0,0,3054,0,0,1,0,1,0,0,0,0,0,0,0,1,0,0,0,0
2021,0,2,A,0,1,3055,0,1,0,3,0,3,2,0,4,1,-3,2,-3,0,0,0,0
2021,2,2,D,0,1,3056,0,1,1,3,1,3,3,0,0,0,0,3,-2,0,0,0,0
2021,4,1,H,0,0,3057,0,0,0,0,0,0,0,2,2,0,-2,-2,0,0,0,0,0
2021,2,5,A,1,1,3058,1,1,3,3,0,3,4,3,2,3,1,1,0,0,0,0,0
2021,0,2,A,0,0,3059,0,0,0,0,0,0,1,4,1,0,-1,-3,0,0,0,0,0
2021,1,4,A,1,1,3060,1,1,3,3,0,3,4,2,0,2,2,2,0,0,0,0,0
2021,1,2,A,1,0,3061,1,0,3,0,0,0,2,6,4,4,0,-4,3,0,0,0,0
2021,4,1,H,1,0,3062,1,0,4,0,1,0,1,6,2,5,3,-5,4,0,0,0,0
2021,0,1,A,0,0,3063,0,0,0,2,0,2,2,2,3,0,-3,0,-2,0,0,0,0
2021,5,2,H,2,0,3064,2,0,6,1,0,1,1,3,3,8,5,-2,5,0,0,0,0
2021,1,0,H,1,1,3065,1,1,3,3,0,3,4,3,7,5,-2,1,0,0,0,0,0
2021,1,1,D,1,2,3066,1,2,3,6,0,6,9,5,4,3,-1,4,-3,0,0,0,0
2021,1,0,H,0,1,3067,0,1,0,4,0,4,1,0,6,1,-5,1,-4,0,0,0,0
2021,3,0,H,2,1,3068,2,1,6,3,0,3,3,4,0,4,4,-1,3,0,0,0,0
2021,4,1,H,2,3,3069,2,3,6,9,0,9,13,5,0,8,8,8,-3,0,0,0,1
2021,1,2,A,2,3,3070,2,3,7,9,1,9,7,0,6,10,4,7,-2,0,0,0,1
2021,3,0,H,1,1,3071,1,1,3,4,0,4,4,5,7,4,-3,-1,-1,0,0,0,0
2021,1,1,D,0,1,3072,0,1,0,4,0,4,5,2,10,2,-8,3,-4,0,0,0,0
2021,3,4,A,1,2,3073,1,2,3,7,0,7,9,3,4,4,0,6,-4,0,0,0,0
2021,2,2,D,1,1,3074,1,1,3,3,0,3,5,6,7,3,-4,-1,0,0,0,0,0
2021,2,3,A,0,0,3075,0,0,0,1,0,1,3,8,5,2,-3,-5,-1,0,0,0,0
2021,3,2,H,0,1,3076,0,1,0,3,0,3,2,6,4,0,-4,-4,-3,0,0,0,0
2021,5,2,H,1,2,3077,1,2,5,6,2,6,6,7,2,3,1,-1,-1,0,0,0,0
2021,0,0,D,1,1,3078,1,1,4,3,1,3,4,7,1,1,0,-3,1,0,0,0,0
2021,3,3,D,3,0,3079,2,0,10,0,1,0,4,8,6,13,7,-4,10,0,0,0,0
2021,1,3,A,3,2,3080,3,1,9,6,0,6,7,7,9,14,5,0,3,0,0,1,0
2021,0,2,A,1,2,3081,1,2,4,7,1,7,11,8,7,4,-3,3,-3,0,0,0,0
2021,2,1,H,1,1,3082,1,1,4,3,1,3,7,8,8,4,-4,-1,1,0,0,0,0
2021,4,2,H,1,0,3083,0,0,4,1,1,1,3,11,10,6,-4,-8,3,0,0,0,0
2021,1,2,A,2,3,3084,2,3,6,9,0,9,12,1,12,8,-4,11,-3,0,0,0,1
2021,2,2,D,1,1,3085,1,1,3,4,0,4,5,9,9,4,-5,-4,-1,0,0,0,0
2021,3,2,H,1,1,3086,1,0,4,3,1,3,3,6,8,7,-1,-3,1,0,0,0,0
2021,1,1,D,1,1,3087,1,1,5,5,2,5,1,1,3,6,3,0,0,0,0,0,0
2021,3,3,D,4,2,3088,3,1,12,8,0,8,8,4,1,9,8,4,4,0,0,1,0
2021,1,2,A,0,3,3089,0,3,1,9,1,9,15,12,15,5,-10,3,-8,0,0,0,1
2021,2,2,D,3,1,3090,2,1,10,4,1,4,6,11,8,13,5,-5,6,0,0,0,0
2021,3,2,H,1,2,3091,1,0,3,7,0,7,10,12,10,8,-2,-2,-4,0,0,0,0
2021,1,2,A,1,4,3092,0,3,3,13,0,13,12,4,9,5,-4,8,-10,0,0,0,1
2021,1,4,A,1,1,3093,1,1,5,6,2,6,7,4,11,7,-4,3,-1,0,0,0,0
2021,3,4,A,0,2,3094,0,1,1,7,1,7,6,9,11,7,-4,-3,-6,0,0,0,0
2021,0,2,A,4,3,3095,3,2,12,11,0,11,16,9,2,14,12,7,1,0,0,1,0
2021,2,0,H,2,2,3096,1,1,9,7,3,7,10,10,7,11,4,0,2,0,0,0,0
2021,1,1,D,3,1,3097,1,1,9,4,0,4,4,9,8,10,2,-5,5,0,0,0,0
2021,3,1,H,1,2,3098,1,2,6,6,3,6,9,14,2,2,0,-5,0,0,0,0,0
2021,1,2,A,1,0,3099,1,0,5,1,2,1,10,15,10,5,-5,-5,4,0,0,0,0
2021,0,0,D,3,1,3100,2,0,14,3,2,3,6,11,9,18,9,-5,11,0,0,0,0
2021,2,0,H,2,3,3101,0,1,7,10,1,9,11,9,15,12,-3,2,-3,0,0,0,0
2021,0,3,A,2,1,3102,2,1,6,5,0,5,8,15,17,10,-7,-7,1,0,0,0,0
2021,0,0,D,1,2,3103,1,1,5,7,1,7,10,12,13,8,-5,-2,-2,0,0,0,0
2021,1,1,D,2,2,3104,1,1,10,9,1,9,11,5,12,10,-2,6,1,0,0,0,0
2021,1,1,D,3,3,3105,3,2,12,11,0,10,15,10,13,17,4,5,1,0,0,1,0
2021,1,3,A,1,2,3106,1,1,5,12,2,9,13,7,12,6,-6,6,-7,0,0,0,0
2021,0,0,D,0,0,3107,0,0,4,1,1,1,6,17,16,12,-4,-11,3,0,0,0,0
2021,0,1,A,1,4,3108,1,3,6,12,0,12,14,4,12,11,-1,10,-6,0,0,0,1
2021,2,2,D,4,1,3109,3,1,16,9,1,6,5,3,5,14,9,2,7,0,0,1,0
2021,0,2,A,0,2,3110,0,1,2,11,1,7,11,13,17,6,-11,-2,-9,0,0,0,0
2021,0,0,D,1,3,3111,1,3,8,13,2,9,18,14,15,11,-4,4,-5,0,0,0,1
2021,2,0,H,2,2,3112,1,0,10,10,3,7,14,15,6,12,6,-1,0,0,0,0,0
2021,0,1,A,2,2,3113,1,2,8,6,1,6,10,20,12,10,-2,-10,2,0,0,0,0
2021,4,2,H,3,0,3114,2,0,12,5,1,1,12,16,11,16,5,-4,7,0,0,0,0
2021,3,0,H,2,1,3115,1,1,15,6,3,4,8,13,8,16,8,-5,9,0,0,0,0
2021,1,2,A,3,1,3116,1,1,10,6,0,3,11,13,11,11,0,-2,4,0,0,0,0
2021,0,2,A,1,3,3117,1,2,10,15,3,11,18,9,5,7,2,9,-5,0,0,0,0
2021,1,0,H,1,1,3118,0,1,4,5,0,5,7,15,11,6,-5,-8,-1,0,0,0,0
2021,1,3,A,4,4,3119,3,3,15,17,0,13,16,7,4,15,11,9,-2,0,0,1,1
2021,0,3,A,3,3,3120,2,2,18,15,2,10,20,13,9,20,11,7,3,0,0,0,0
2021,1,1,D,2,2,3121,2,1,9,13,0,9,14,6,20,11,-9,8,-4,0,0,0,0
2021,0,2,A,3,1,3122,3,1,14,10,0,6,7,7,14,18,4,0,4,0,0,1,0
2021,1,3,A,2,1,3123,1,0,14,7,1,3,7,11,13,13,0,-4,7,0,0,0,0
2021,1,0,H,1,0,3124,1,0,9,2,0,1,6,19,14,13,-1,-13,7,0,0,0,0
2021,2,0,H,4,2,3125,3,1,20,8,1,7,10,13,8,19,11,-3,12,0,0,1,0
2021,2,2,D,2,1,3126,0,1,10,9,1,5,11,15,17,14,-3,-4,1,0,0,0,0
2021,4,0,H,4,2,3127,3,1,15,18,0,9,19,8,7,16,9,11,-3,0,0,1,0
2021,2,2,D,0,3,3128,0,1,5,10,1,9,12,13,20,14,-6,-1,-5,0,0,0,0
2021,1,2,A,1,1,3129,1,1,5,6,2,4,8,16,16,7,-9,-8,-1,0,0,0,0
2021,1,2,A,1,2,3130,1,1,10,14,2,7,14,16,17,13,-4,-2,-4,0,0,0,0
2021,2,1,H,2,0,3131,1,0,14,6,3,1,16,22,7,15,8,-6,8,0,0,0,0
2021,3,1,H,3,1,3132,2,1,18,12,1,3,14,14,13,23,10,0,6,0,0,0,0
2021,1,1,D,1,2,3133,1,0,13,11,3,7,16,19,7,9,2,-3,2,0,0,0,0
2021,0,0,D,1,2,3134,1,2,9,10,1,6,12,21,17,10,-7,-9,-1,0,0,0,0
2021,0,0,D,2,3,3135,1,2,18,18,3,11,20,12,12,19,7,8,0,0,0,0,0
2021,0,4,A,0,4,3136,0,3,2,18,1,12,20,7,20,6,-14,13,-16,0,0,0,1
2021,1,2,A,3,4,3137,1,3,11,23,0,13,21,8,15,14,-1,13,-12,0,0,0,1
2021,1,1,D,2,1,3138,1,1,8,5,1,5,8,18,15,10,-5,-10,3,0,0,0,0
2021,1,0,H,3,2,3139,2,2,19,11,2,6,12,21,12,20,8,-9,8,0,0,0,0
2021,4,1,H,0,1,3140,0,1,2,10,1,5,14,19,24,6,-18,-5,-8,0,0,0,0
2021,2,3,A,0,1,3141,0,0,6,10,1,3,10,12,24,17,-7,-2,-4,0,0,0,0
2021,1,2,A,2,1,3142,1,1,17,14,1,6,10,8,17,16,-1,2,3,0,0,0,0
2021,1,3,A,2,3,3143,0,2,12,21,1,10,26,14,20,17,-3,12,-9,0,0,0,0
2021,3,0,H,3,2,3144,3,1,14,9,0,7,11,16,16,18,2,-5,5,0,0,1,0
2021,1,5,A,1,2,3145,1,1,12,19,0,9,19,12,17,15,-2,7,-7,0,0,0,0
2021,2,1,H,4,3,3146,3,1,21,11,0,9,15,17,7,24,17,-2,10,0,0,1,0
2021,1,3,A,1,2,3147,1,1,6,17,2,9,17,8,19,9,-10,9,-11,0,0,0,0
2021,2,2,D,4,1,3148,3,1,26,10,1,4,10,17,9,23,14,-7,16,0,0,1,0
2021,0,0,D,1,0,3149,0,0,13,5,0,1,10,25,14,13,-1,-15,8,0,0,0,0
2021,1,1,D,2,2,3150,2,1,11,17,0,7,17,19,22,12,-10,-2,-6,0,0,0,0
2021,1,1,D,2,3,3151,1,3,20,17,3,9,21,16,9,20,11,5,3,0,0,0,1
2021,1,1,D,2,3,3152,1,2,9,22,1,11,21,12,19,11,-8,9,-13,0,0,0,0
2021,2,2,D,1,4,3153,1,3,6,27,2,13,25,11,22,10,-12,14,-21,0,0,0,1
2021,1,0,H,3,4,3154,2,3,24,24,1,12,26,8,15,29,14,18,0,0,0,0,1
2021,0,0,D,1,2,3155,1,0,11,12,1,7,18,23,19,12,-7,-5,-1,0,0,0,0
2021,2,2,D,1,1,3156,1,1,10,12,2,3,16,22,23,15,-8,-6,-2,0,0,0,0
2021,1,2,A,1,3,3157,1,1,17,11,3,9,16,19,9,12,3,-3,6,0,0,0,0
2021,3,1,H,2,0,3158,1,0,22,6,3,1,19,27,13,24,11,-8,16,0,0,0,0
2021,1,1,D,2,1,3159,1,1,10,17,1,6,13,11,20,12,-8,2,-7,0,0,0,0
2021,3,1,H,3,0,3160,1,0,14,6,0,1,10,25,20,18,-2,-15,8,0,0,0,0
2021,0,4,A,1,2,3161,1,1,12,21,1,9,21,10,19,12,-7,11,-9,0,0,0,0
2021,1,1,D,0,1,3162,0,1,6,13,1,3,18,24,30,20,-10,-6,-7,0,0,0,0
2021,2,0,H,2,1,3163,2,1,12,7,0,5,12,24,23,13,-10,-12,5,0,0,0,0
2021,1,1,D,2,1,3164,0,0,13,14,1,3,13,14,23,18,-5,-1,-1,0,0,0,0
2021,2,1,H,3,1,3165,2,1,27,11,1,5,17,25,15,30,15,-8,16,0,0,0,0
2021,1,2,A,3,4,3166,2,3,23,28,2,13,27,13,13,22,9,14,-5,0,0,0,1
2021,4,1,H,3,2,3167,3,1,18,25,0,9,27,14,17,22,5,13,-7,0,0,1,0
2021,2,0,H,2,4,3168,1,3,18,24,1,12,26,9,20,18,-2,17,-6,0,0,0,1
2021,2,1,H,0,1,3169,0,1,6,12,1,4,12,23,28,11,-17,-11,-6,0,0,0,0
2021,0,3,A,2,2,3170,1,1,24,11,3,7,13,21,10,25,15,-8,13,0,0,0,0
2021,1,2,A,1,3,3171,1,2,18,30,3,10,32,16,12,14,2,16,-12,0,0,0,0
2021,2,2,D,1,3,3172,1,3,14,21,0,9,26,18,25,19,-6,8,-7,0,0,0,1
2021,3,2,H,4,2,3173,3,1,31,21,1,7,20,20,14,29,15,0,10,0,0,1,0
2021,1,1,D,4,0,3174,3,0,24,7,0,1,21,31,11,26,15,-10,17,0,0,1,0
2021,3,2,H,2,2,3175,1,0,25,14,3,7,19,24,18,28,10,-5,11,0,0,0,0
2021,2,3,A,3,3,3176,1,2,17,23,0,11,23,15,21,21,0,8,-6,0,0,0,0
2021,1,2,A,1,1,3177,1,1,11,7,2,5,12,26,27,18,-9,-14,4,0,0,0,0
2021,0,2,A,1,2,3178,0,2,15,15,0,6,15,23,15,14,-1,-8,0,0,0,0,0
2021,6,2,H,3,0,3179,2,0,33,9,1,1,13,29,17,34,17,-16,24,0,0,0,0
2021,5,1,H,3,3,3180,3,2,22,26,0,11,26,17,20,28,8,9,-4,0,0,1,0
2021,1,4,A,2,4,3181,0,3,14,25,1,12,27,12,27,21,-6,15,-11,0,0,0,1
2021,0,0,D,2,1,3182,1,1,14,15,1,3,21,27,21,16,-5,-6,-1,0,0,0,0
2021,1,1,D,1,2,3183,1,1,10,21,2,7,22,23,27,14,-13,-1,-11,0,0,0,0
2021,0,3,A,1,0,3184,1,0,12,8,1,1,22,32,25,13,-12,-10,4,0,0,0,0
2021,1,0,H,2,3,3185,1,1,28,17,3,9,23,24,20,31,11,-1,11,0,0,0,0
2021,0,1,A,1,1,3186,1,1,11,18,2,6,15,14,29,19,-10,1,-7,0,0,0,0
2021,0,2,A,2,4,3187,2,3,18,34,0,13,32,16,23,17,-6,16,-16,0,0,0,1
2021,4,1,H,2,1,3188,1,0,24,15,3,3,14,17,13,25,12,-3,9,0,0,0,0
2021,1,2,A,2,2,3189,0,2,14,18,1,6,17,25,31,22,-9,-8,-4,0,0,0,0
2021,3,0,H,3,1,3190,3,1,25,12,0,4,13,28,21,33,12,-15,13,0,0,1,0
2021,2,2,D,1,1,3191,1,0,16,15,0,3,15,21,27,21,-6,-6,1,0,0,0,0
2021,1,3,A,0,2,3192,0,1,9,31,1,9,32,20,35,15,-20,12,-22,0,0,0,0
2021,2,1,H,2,2,3193,1,1,22,15,1,7,16,21,24,23,-1,-5,7,0,0,0,0
2021,2,1,H,3,3,3194,1,2,17,36,0,10,40,19,25,23,-2,21,-19,0,0,0,0
2021,2,1,H,3,1,3195,2,1,26,11,2,5,15,28,22,27,5,-13,15,0,0,0,0
2021,1,1,D,0,1,3196,0,1,11,21,1,6,16,14,32,25,-7,2,-10,0,0,0,0
2021,1,2,A,4,1,3197,3,1,28,11,0,5,19,30,13,31,18,-11,17,0,0,1,0
2021,1,3,A,4,2,3198,3,1,37,27,1,9,29,14,16,34,18,15,10,0,0,1,0
2021,1,4,A,2,3,3199,2,3,21,28,0,9,36,21,26,19,-7,15,-7,0,0,0,1
2021,2,0,H,1,1,3200,1,1,11,17,2,3,23,29,30,16,-14,-6,-6,0,0,0,0
2021,2,0,H,4,0,3201,3,0,37,12,1,1,26,33,19,35,16,-7,25,0,0,1,0
2021,2,2,D,2,3,3202,1,2,34,36,3,10,41,21,21,35,14,20,-2,0,0,0,0
2021,0,2,A,1,2,3203,1,1,12,25,1,7,25,25,31,13,-18,0,-13,0,0,0,0
2021,1,2,A,1,4,3204,0,3,16,28,0,12,32,15,23,17,-6,17,-12,0,0,0,1
2021,2,1,H,1,0,3205,1,0,22,9,3,1,16,38,15,17,2,-22,13,0,0,0,0
2021,1,0,H,2,2,3206,1,0,15,14,1,7,23,33,23,17,-6,-10,1,0,0,0,0
2021,3,1,H,2,3,3207,1,2,30,29,3,11,29,23,15,32,17,6,1,0,0,0,0
2021,2,1,H,1,3,3208,1,1,14,20,2,9,25,26,31,21,-10,-1,-6,0,0,0,0
2021,3,0,H,2,2,3209,1,1,28,35,1,9,37,23,25,27,2,14,-7,0,0,0,0
2021,1,0,H,1,1,3210,1,1,17,25,0,6,19,16,31,23,-8,3,-8,0,0,0,0
2021,0,0,D,0,1,3211,0,1,12,17,1,5,23,32,35,26,-9,-9,-5,0,0,0,0
2021,2,1,H,3,1,3212,1,0,20,16,0,3,18,25,28,26,-2,-7,4,0,0,0,0
2021,6,0,H,4,2,3213,3,1,31,18,0,7,18,23,16,34,18,-5,13,0,0,1,0
2021,4,1,H,0,2,3214,0,2,9,21,1,6,20,30,40,17,-23,-10,-12,0,0,0,0
2021,1,1,D,3,1,3215,2,1,29,12,2,4,13,33,26,30,4,-20,17,0,0,0,0
2021,0,0,D,3,1,3216,3,1,31,14,0,5,18,30,22,40,18,-12,17,0,0,1,0
2021,2,0,H,3,2,3217,2,1,37,33,1,9,35,16,23,43,20,19,4,0,0,0,0
2021,0,2,A,2,4,3218,0,3,14,40,1,13,37,19,34,23,-11,18,-26,0,0,0,1
2021,1,1,D,1,3,3219,0,3,16,32,0,9,40,22,27,19,-8,18,-16,0,0,0,1
2021,2,2,D,2,0,3220,2,0,21,13,0,1,26,35,34,21,-13,-9,8,0,0,0,0
2021,4,3,H,2,1,3221,1,1,35,18,3,5,23,32,26,37,11,-9,17,0,0,0,0
2021,0,3,A,4,3,3222,3,3,43,33,1,9,41,23,19,39,20,18,10,0,0,1,1
2021,0,0,D,1,3,3223,0,2,17,40,0,10,45,23,28,20,-8,22,-23,0,0,0,0
2021,2,1,H,2,0,3224,1,0,18,12,1,1,21,41,29,18,-11,-20,6,0,0,0,0
2021,2,0,H,2,1,3225,1,1,33,20,3,3,24,31,18,35,17,-7,13,0,0,0,0
2021,1,0,H,1,2,3226,1,0,15,14,2,7,23,36,30,18,-12,-13,1,0,0,0,0
2021,3,1,H,1,4,3227,1,3,25,34,3,12,40,16,17,19,2,24,-9,0,0,0,1
2021,2,1,H,2,3,3228,1,2,31,30,1,11,31,27,25,30,5,4,1,0,0,0,0
2021,0,2,A,1,3,3229,1,1,13,23,1,9,28,29,34,14,-20,-1,-10,0,0,0,0
2021,1,1,D,0,2,3230,0,1,14,21,4,7,20,30,37,28,-9,-10,-7,0,0,0,0
2021,1,2,A,1,4,3231,1,3,20,43,3,13,39,22,33,24,-9,17,-23,0,0,0,1
2021,0,2,A,3,2,3232,1,1,26,36,3,9,37,18,29,30,1,19,-10,0,0,0,0
2021,4,0,H,3,2,3233,2,2,41,22,1,6,23,36,23,45,22,-13,19,0,0,0,0
2021,0,1,A,1,1,3234,1,0,18,18,2,3,20,28,36,26,-10,-8,0,0,0,0,0
2021,1,3,A,3,2,3235,3,1,36,34,0,7,32,26,23,44,21,6,2,0,0,1,0
2021,1,1,D,2,3,3236,0,2,14,30,1,11,32,29,37,23,-14,3,-16,0,0,0,0
2021,0,3,A,0,1,3237,0,1,12,18,4,5,19,30,43,22,-21,-11,-6,0,0,0,0
2021,2,0,H,4,1,3238,3,1,34,13,0,4,14,36,19,41,22,-22,21,0,0,1,0
2021,3,1,H,2,1,3239,1,1,38,28,3,6,22,18,29,41,12,4,10,0,0,0,0
2021,0,2,A,2,3,3240,1,2,22,44,4,10,49,23,31,21,-10,26,-22,0,0,0,0
2021,3,3,D,3,0,3241,3,0,36,15,0,1,29,38,26,45,19,-9,21,0,0,1,0
2021,1,2,A,3,1,3242,2,1,31,18,2,5,26,37,30,33,3,-11,13,0,0,0,0
2021,2,0,H,2,2,3243,1,1,39,41,3,9,44,30,18,39,21,14,-2,0,0,0,0
2021,2,1,H,1,4,3244,1,3,21,37,5,12,43,19,30,22,-8,24,-16,0,0,0,1
2021,1,1,D,2,3,3245,2,1,22,26,0,9,30,31,40,23,-17,-1,-4,0,0,0,0
2021,4,0,H,4,0,3246,3,0,46,12,1,1,22,46,23,41,18,-24,34,0,0,1,0
2021,2,0,H,1,1,3247,0,1,21,28,3,6,23,21,28,21,-7,2,-7,0,0,0,0
2021,0,3,A,1,1,3248,1,1,13,20,4,3,25,35,38,14,-24,-10,-7,0,0,0,0
2021,1,0,H,2,2,3249,1,0,37,15,1,7,24,38,27,35,8,-14,22,0,0,0,0
2021,1,1,D,1,2,3250,1,2,23,23,3,6,24,41,35,28,-7,-17,0,0,0,0,0
2021,0,0,D,0,1,3251,0,1,16,24,1,5,24,31,41,32,-9,-7,-8,0,0,0,0
2021,1,0,H,4,2,3252,3,1,37,42,0,9,41,18,21,44,23,23,-5,0,0,1,0
2021,2,0,H,1,4,3253,1,3,21,49,5,13,45,23,38,28,-10,22,-28,0,0,0,1
2021,3,0,H,2,1,3254,1,0,41,24,3,3,23,28,32,44,12,-5,17,0,0,0,0
2021,0,1,A,2,3,3255,0,3,15,37,4,9,48,29,39,24,-15,19,-22,0,0,0,1
2021,2,1,H,3,2,3256,1,1,27,22,0,7,21,33,32,31,-1,-12,5,0,0,0,0
2021,1,2,A,0,3,3257,0,2,12,31,4,11,34,32,50,22,-28,2,-19,0,0,0,0
2021,3,1,H,3,2,3258,2,1,47,40,1,7,36,27,23,51,28,9,7,0,0,0,0
2021,2,1,H,1,1,3259,1,1,28,13,6,4,14,41,23,23,0,-27,15,0,0,0,0
2021,3,0,H,2,1,3260,1,1,22,24,1,5,30,38,35,22,-13,-8,-2,0,0,0,0
2021,0,1,A,2,0,3261,0,0,15,17,1,1,32,41,40,24,-16,-9,-2,0,0,0,0
2021,1,0,H,2,3,3262,1,1,40,30,4,9,33,33,30,37,7,0,10,0,0,0,0
2021,2,2,D,1,1,3263,1,1,25,31,2,6,25,24,31,24,-7,1,-6,0,0,0,0
2021,1,1,D,3,1,3264,2,1,34,24,2,3,29,36,33,36,3,-7,10,0,0,0,0
2021,2,2,D,1,1,3265,1,0,13,24,4,3,23,31,43,15,-28,-8,-11,0,0,0,0
2021,0,3,A,4,3,3266,3,2,49,50,1,10,54,24,25,45,20,30,-1,0,0,1,0
2021,4,2,H,3,4,3267,3,3,40,40,3,12,45,21,29,49,20,24,0,0,0,1,1
2021,0,0,D,2,2,3268,2,1,24,44,3,9,47,32,42,25,-17,15,-20,0,0,0,0
2021,3,0,H,2,0,3269,1,0,42,12,3,1,23,52,19,41,22,-29,30,0,0,0,0
2021,2,2,D,1,1,3270,1,1,24,14,2,4,17,45,41,30,-11,-28,10,0,0,0,0
2021,2,0,H,1,2,3271,1,1,25,43,3,7,38,30,37,30,-7,8,-18,0,0,0,0
2021,1,1,D,1,2,3272,1,1,32,45,3,9,44,19,26,27,1,25,-13,0,0,0,0
2021,0,2,A,3,3,3273,1,3,30,43,0,9,53,31,34,33,-1,22,-13,0,0,0,1
2021,0,2,A,0,2,3274,0,0,12,15,4,7,24,41,55,23,-32,-17,-3,0,0,0,0
2021,3,0,H,3,1,3275,2,1,53,26,1,5,26,33,24,57,33,-7,27,0,0,0,0
2021,1,0,H,1,2,3276,0,1,25,25,3,7,25,35,33,25,-8,-10,0,0,0,0,0
2021,2,0,H,4,2,3277,3,2,40,25,0,6,25,42,25,47,22,-17,15,0,0,1,0
2021,1,2,A,2,4,3278,1,3,45,49,3,13,45,28,32,47,15,17,-4,0,0,0,1
2021,3,0,H,2,1,3279,1,1,46,25,3,5,32,43,20,45,25,-11,21,0,0,0,0
2021,3,3,D,3,4,3280,2,3,35,43,2,12,49,25,34,37,3,24,-8,0,0,0,1
2021,5,1,H,3,0,3281,3,0,46,12,0,1,23,57,31,55,24,-34,34,0,0,1,0
2021,0,3,A,2,1,3282,2,1,25,33,0,6,28,27,44,25,-19,1,-8,0,0,0,0
2021,1,0,H,2,1,3283,0,1,18,28,1,3,32,37,41,26,-15,-5,-10,0,0,0,0
2021,1,2,A,2,2,3284,1,1,25,45,1,9,48,34,36,25,-11,14,-20,0,0,0,0
2021,1,1,D,1,3,3285,1,1,26,30,2,9,33,36,36,26,-10,-3,-4,0,0,0,0
2021,1,1,D,4,1,3286,3,0,52,28,1,3,26,33,29,47,18,-7,24,0,0,1,0
2021,1,2,A,1,3,3287,1,2,15,56,1,10,60,24,47,19,-28,36,-41,0,0,0,0
2021,1,1,D,1,2,3288,1,2,25,25,2,6,25,47,46,32,-14,-22,0,0,0,0,0
2021,2,0,H,1,3,3289,0,2,29,36,0,11,40,37,34,27,-7,3,-7,0,0,0,0
2021,3,1,H,2,2,3290,1,1,49,43,3,7,38,32,20,48,28,6,6,0,0,0,0
2021,1,0,H,2,1,3291,1,1,48,27,3,5,27,37,35,50,15,-10,21,0,0,0,0
2021,4,2,H,0,0,3292,0,0,12,20,1,1,33,41,62,24,-38,-8,-8,0,0,0,0
2021,3,3,D,2,1,3293,1,1,25,15,1,4,20,49,38,26,-12,-29,10,0,0,0,0
2021,0,2,A,1,4,3294,1,3,36,53,3,13,48,30,27,31,4,18,-17,0,0,0,1
2021,2,2,D,3,2,3295,1,0,31,21,0,7,27,41,37,34,-3,-14,10,0,0,0,0
2021,3,1,H,4,1,3296,3,1,44,28,0,3,32,38,28,52,24,-6,16,0,0,1,0
2021,1,0,H,3,3,3297,2,3,59,49,1,9,60,32,25,62,37,28,10,0,0,0,1
2021,3,2,H,2,0,3298,1,0,43,15,1,1,28,64,35,39,4,-36,28,0,0,0,0
2021,3,1,H,3,1,3299,3,1,49,26,0,5,33,47,33,60,27,-14,23,0,0,1,0
2021,3,2,H,3,1,3300,2,1,36,36,2,6,31,29,39,40,1,2,0,0,0,0,0
2021,1,4,A,2,2,3301,2,1,26,26,0,7,29,41,48,26,-22,-12,0,0,0,0,0
2021,1,1,D,1,1,3302,1,0,27,32,2,3,29,34,38,27,-11,-5,-5,0,0,0,0
2021,3,1,H,1,3,3303,1,1,28,32,0,9,36,39,41,33,-8,-3,-4,0,0,0,0
2021,2,0,H,1,2,3304,1,1,16,51,1,9,51,35,52,23,-29,16,-35,0,0,0,0
2021,1,2,A,0,3,3305,0,2,20,62,1,10,63,25,45,35,-10,38,-42,0,0,0,0
2021,1,3,A,2,2,3306,0,1,22,52,1,9,51,21,43,29,-14,30,-30,0,0,0,0
2021,0,1,A,4,4,3307,3,3,56,47,1,12,55,29,30,50,20,26,9,0,0,1,1
2021,3,2,H,0,3,3308,0,2,20,39,1,11,43,41,47,36,-11,2,-19,0,0,0,0
2021,1,2,A,1,1,3309,1,1,19,28,1,5,28,39,52,25,-27,-11,-9,0,0,0,0
2021,2,3,A,0,1,3310,0,1,15,31,1,3,36,42,67,30,-37,-6,-16,0,0,0,0
2021,2,1,H,1,2,3311,1,0,26,22,2,7,30,46,50,34,-16,-16,4,0,0,0,0
2021,0,2,A,1,3,3312,1,3,36,52,3,9,63,34,32,33,1,29,-16,0,0,0,1
2021,0,1,A,2,2,3313,1,2,55,26,3,6,27,52,22,54,32,-25,29,0,0,0,0
2021,1,0,H,3,0,3314,1,0,32,23,0,1,39,49,42,37,-5,-10,9,0,0,0,0
2021,0,1,A,1,2,3315,0,1,33,46,0,7,42,37,35,30,-5,5,-13,0,0,0,0
2021,2,3,A,2,4,3316,1,3,29,56,1,13,50,31,42,33,-9,19,-27,0,0,0,1
2021,0,2,A,2,4,3317,1,3,51,50,3,12,56,29,37,51,14,27,1,0,0,0,1
2021,1,1,D,4,3,3318,3,1,59,35,1,9,38,42,33,53,20,-4,24,0,0,1,0
2021,3,2,H,3,1,3319,3,0,55,33,0,3,30,36,34,65,31,-6,22,0,0,1,0
2021,2,2,D,2,1,3320,2,1,29,19,0,4,26,54,52,28,-24,-28,10,0,0,0,0
2021,0,2,A,2,1,3321,0,1,22,36,1,6,33,34,48,31,-17,-1,-14,0,0,0,0
2021,1,1,D,1,2,3322,1,1,31,29,2,7,35,45,40,30,-10,-10,2,0,0,0,0
2021,2,1,H,2,1,3323,1,1,49,29,1,5,36,51,37,43,6,-15,20,0,0,0,0
2021,4,3,H,4,0,3324,3,0,53,15,0,1,32,70,29,58,29,-38,38,0,0,1,0
2021,2,2,D,3,2,3325,2,1,39,51,2,9,51,39,44,45,1,12,-12,0,0,0,0
2021,2,2,D,0,2,3326,0,1,23,55,1,9,54,23,50,39,-11,31,-32,0,0,0,0
2021,0,1,A,1,3,3327,1,2,34,65,0,10,65,26,44,39,-5,39,-31,0,0,0,0
2021,2,1,H,3,3,3328,2,2,68,40,1,11,47,46,26,66,40,1,28,0,0,0,0
2021,2,1,H,2,4,3329,1,3,56,56,3,12,62,32,25,56,31,30,0,0,0,0,1
2021,3,2,H,1,0,3330,1,0,29,15,2,1,35,74,53,37,-16,-39,14,0,0,0,0
2021,1,3,A,1,4,3331,1,3,20,60,1,13,54,34,56,28,-28,20,-40,0,0,0,1
2021,0,1,A,1,0,3332,0,0,33,24,0,1,41,52,39,32,-7,-11,9,0,0,0,0
2021,1,0,H,3,2,3333,2,0,71,22,1,7,31,50,27,68,41,-19,49,0,0,0,0
2021,3,1,H,2,1,3334,1,1,59,32,3,5,31,41,26,58,32,-10,27,0,0,0,0
2021,0,2,A,3,4,3335,1,3,36,56,0,12,63,34,43,39,-4,29,-20,0,0,0,1
2021,0,1,A,1,2,3336,1,1,39,52,3,7,45,38,34,35,1,7,-13,0,0,0,0
2021,1,0,H,2,1,3337,1,1,52,34,3,3,39,45,41,53,12,-6,18,0,0,0,0
2021,2,3,A,2,3,3338,1,3,30,58,1,9,68,36,46,36,-10,32,-28,0,0,0,1
2021,0,1,A,2,3,3339,2,2,30,40,0,11,48,48,54,30,-24,0,-10,0,0,0,0
2021,1,2,A,0,1,3340,0,0,15,33,1,3,32,40,77,37,-40,-8,-18,0,0,0,0
2021,3,1,H,3,1,3341,1,1,36,39,0,6,35,35,45,39,-6,0,-3,0,0,0,0
2021,3,1,H,3,2,3342,2,1,43,30,2,7,38,49,48,49,1,-11,13,0,0,0,0
2021,4,3,H,2,1,3343,0,1,22,20,1,4,29,59,51,31,-20,-30,2,0,0,0,0
2021,2,1,H,4,1,3344,3,1,63,32,1,5,32,44,35,57,22,-12,31,0,0,1,0
2021,1,0,H,3,2,3345,3,1,61,62,0,9,61,27,38,71,33,34,-1,0,0,1,0
2021,4,1,H,1,1,3346,1,1,34,32,0,5,40,55,46,39,-7,-15,2,0,0,0,0
2021,5,3,H,2,2,3347,1,2,55,30,1,6,30,55,38,46,8,-25,25,0,0,0,0
2021,3,1,H,0,2,3348,0,1,27,55,1,9,54,41,52,42,-10,13,-28,0,0,0,0
2021,1,1,D,4,3,3349,3,2,59,74,0,10,69,27,34,65,31,42,-15,0,0,1,0
2021,1,2,A,1,2,3350,1,1,39,30,3,7,39,52,38,36,-2,-13,9,0,0,0,0
2021,1,2,A,4,3,3351,3,2,66,46,1,11,52,49,36,59,23,3,20,0,0,1,0
2021,1,1,D,1,0,3352,1,0,37,30,0,1,45,53,47,43,-4,-8,7,0,0,0,0
2021,0,1,A,0,3,3353,0,1,15,39,1,9,42,46,79,38,-41,-4,-24,0,0,0,0
2021,2,2,D,1,2,3354,1,2,32,30,2,6,33,60,46,33,-13,-27,2,0,0,0,0
2021,3,1,H,2,1,3355,1,1,62,20,3,4,32,63,28,61,33,-31,42,0,0,0,0
2021,1,1,D,1,3,3356,1,2,32,75,2,10,70,28,59,41,-18,42,-43,0,0,0,0
2021,0,1,A,1,2,3357,0,0,36,25,0,7,35,54,41,34,-7,-19,11,0,0,0,0
2021,1,1,D,2,3,3358,1,3,55,64,3,9,72,38,44,55,11,34,-9,0,0,0,1
2021,5,2,H,4,2,3359,3,1,60,58,0,7,51,41,35,66,31,10,2,0,0,1,0
2021,2,0,H,1,1,3360,1,1,33,33,2,5,42,60,48,35,-13,-18,0,0,0,0,0
2021,3,4,A,1,0,3361,1,0,20,15,1,1,38,80,66,33,-33,-42,5,0,0,0,0
2021,1,0,H,3,3,3362,2,1,49,42,2,9,43,46,50,54,4,-3,7,0,0,0,0
2021,2,4,A,2,1,3363,2,0,31,36,0,3,34,42,62,35,-27,-8,-5,0,0,0,0
2021,1,1,D,2,2,3364,1,1,33,65,1,9,64,29,53,41,-12,35,-32,0,0,0,0
2021,1,0,H,3,1,3365,2,1,76,39,1,6,37,40,29,71,42,-3,37,0,0,0,0
2021,3,2,H,2,2,3366,0,1,28,56,1,9,56,45,54,36,-18,11,-28,0,0,0,0
2021,5,0,H,3,1,3367,3,1,65,38,0,3,44,48,39,73,34,-4,27,0,0,1,0
2021,0,2,A,0,4,3368,0,3,31,63,1,12,71,37,54,46,-8,34,-32,0,0,0,1
2021,3,0,H,2,4,3369,1,3,58,66,1,13,60,38,46,53,7,22,-8,0,0,0,1
2021,1,1,D,1,1,3370,1,1,39,33,3,5,42,62,41,37,-4,-20,6,0,0,0,0
2021,0,2,A,0,3,3371,0,2,18,79,1,10,72,29,83,42,-41,43,-61,0,0,0,0
2021,2,0,H,4,2,3372,3,2,66,31,1,6,37,66,41,60,19,-29,35,0,0,1,0
2021,4,3,H,2,1,3373,1,1,61,36,1,5,37,48,46,56,10,-11,25,0,0,0,0
2021,3,3,D,1,2,3374,1,1,38,34,0,7,42,54,53,44,-9,-12,4,0,0,0,0
2021,1,1,D,4,2,3375,3,0,66,31,0,7,39,56,37,73,36,-17,35,0,0,1,0
2021,1,1,D,3,3,3376,2,3,52,68,2,9,78,39,50,55,5,39,-16,0,0,0,1
2021,1,2,A,1,2,3377,0,1,39,66,0,9,65,30,44,38,-6,35,-27,0,0,0,0
2021,2,0,H,3,2,3378,1,1,42,56,0,9,58,48,47,43,-4,10,-14,0,0,0,0
2021,1,0,H,0,1,3379,0,1,31,20,1,4,36,70,56,46,-10,-34,11,0,0,0,0
2021,1,4,A,1,4,3380,1,3,34,67,2,12,74,38,63,43,-20,36,-33,0,0,0,1
2021,1,1,D,1,1,3381,0,1,39,39,0,3,47,56,46,39,-7,-9,0,0,0,0,0
2021,5,1,H,3,3,3382,2,1,82,45,1,9,45,47,29,74,45,-2,37,0,0,0,0
2021,2,0,H,2,2,3383,1,1,35,64,1,7,60,49,57,45,-12,11,-29,0,0,0,0
2021,1,2,A,1,3,3384,1,2,36,53,2,11,56,51,52,40,-12,5,-17,0,0,0,0
2021,1,3,A,2,2,3385,2,0,31,32,0,7,40,57,68,37,-31,-17,-1,0,0,0,0
2021,2,5,A,1,3,3386,1,3,20,69,1,9,79,40,71,36,-35,39,-49,0,0,0,1
2021,1,1,D,1,0,3387,1,0,40,34,3,1,47,56,42,38,-4,-9,6,0,0,0,0
2021,5,0,H,2,0,3388,1,0,56,18,3,1,42,85,50,58,8,-43,38,0,0,0,0
2021,0,3,A,2,4,3389,1,3,69,69,3,13,62,41,31,67,36,21,0,0,0,0,1
2021,5,1,H,4,1,3390,3,0,70,40,0,3,40,47,39,78,39,-7,30,0,0,1,0
2021,0,0,D,2,2,3391,0,1,35,38,1,7,47,57,58,43,-15,-10,-3,0,0,0,0
2021,2,0,H,3,2,3392,3,2,72,31,0,6,38,71,42,84,42,-33,41,0,0,1,0
2021,0,2,A,1,1,3393,1,1,40,36,0,5,41,54,57,48,-9,-13,4,0,0,0,0
2021,3,1,H,3,2,3394,2,1,85,59,1,9,63,50,30,79,49,13,26,0,0,0,0
2021,1,0,H,2,1,3395,1,1,64,20,1,4,38,76,51,60,9,-38,44,0,0,0,0
2021,2,2,D,3,1,3396,1,1,45,34,0,5,44,67,52,46,-6,-23,11,0,0,0,0
2021,1,3,A,3,2,3397,2,1,56,69,2,9,67,34,52,58,6,33,-13,0,0,0,0
2021,0,7,A,0,4,3398,0,3,35,72,1,13,65,41,57,48,-9,24,-37,0,0,0,1
2021,2,1,H,0,1,3399,0,1,18,41,1,6,39,43,90,42,-48,-4,-23,0,0,0,0
2021,3,4,A,1,3,3400,1,3,39,75,2,9,86,42,54,43,-11,44,-36,0,0,0,1
2021,4,1,H,1,0,3401,1,0,35,35,2,1,48,64,69,46,-23,-16,0,0,0,0,0
2021,3,2,H,2,3,3402,1,2,72,88,3,10,82,31,35,70,35,51,-16,0,0,0,0
2021,2,0,H,2,2,3403,1,1,59,67,3,7,61,51,53,64,11,10,-8,0,0,0,0
2021,0,2,A,2,4,3404,1,3,39,73,1,12,83,40,57,47,-10,43,-34,0,0,0,1
2021,1,1,D,2,0,3405,2,0,31,21,0,1,44,91,73,38,-35,-47,10,0,0,0,0
2021,0,1,A,1,3,3406,0,1,40,46,0,9,48,54,52,41,-11,-6,-6,0,0,0,0
2021,1,3,A,1,3,3407,1,2,20,56,1,11,59,55,77,38,-39,4,-36,0,0,0,0
2021,0,0,D,4,2,3408,3,0,75,36,1,7,43,58,41,72,31,-15,39,0,0,1,0
2021,2,2,D,1,1,3409,1,1,41,40,3,3,48,59,45,40,-5,-11,1,0,0,0,0
2021,0,0,D,2,0,3410,1,0,67,35,1,1,49,68,53,61,8,-19,32,0,0,0,0
2021,0,1,A,2,1,3411,0,1,37,39,1,5,46,58,58,43,-15,-12,-2,0,0,0,0
2021,0,0,D,0,2,3412,0,1,22,39,1,7,47,59,92,45,-47,-12,-17,0,0,0,0
2021,3,0,H,3,1,3413,1,1,49,20,0,4,39,80,54,49,-5,-41,29,0,0,0,0
2021,5,1,H,3,1,3414,2,0,88,40,1,3,41,53,34,84,50,-12,48,0,0,0,0
2021,0,2,A,3,4,3415,3,3,78,76,0,13,72,41,45,90,45,31,2,0,0,1,1
2021,1,4,A,1,2,3416,1,1,41,75,0,9,73,37,61,50,-11,36,-34,0,0,0,0
2021,1,1,D,4,1,3417,3,1,76,42,0,6,42,47,40,85,45,-5,34,0,0,1,0
2021,2,0,H,3,2,3418,2,1,59,68,2,7,61,53,56,62,6,8,-9,0,0,0,0
2021,2,2,D,1,2,3419,1,1,38,62,2,9,66,53,70,50,-20,13,-24,0,0,0,0
2021,1,1,D,0,2,3420,0,2,36,32,1,6,39,74,68,49,-19,-35,4,0,0,0,0
